dam west campground carlyle illinois	Western_United_States	Carlyle_Lake	Dam	Campsite	Carlyle,_Illinois
google youtube	History_of_YouTube	Youtube	Google	YouTube
google search	Google_Search	Google	Google_search
obama family tree	Michelle_Obama	Family_tree	Family_of_Barack_Obama
obama mother bio	The_Biography_Channel	Michelle_Obama	Mother_(1996_film)	Barack_Obama	Ann_Dunham
buy volvo semi trucks	Volvo_Trucks	Semi_trucks	Buy,_Kostroma_Oblast	Semi-trailer_truck
reviews xc90	Review	Joli_OS	Volvo_XC90
kmart	Kmart_Australia	Kmart
sears	Sears	Sears_Canada
best but	The_Best_of_Everything_but_the_Girl	Pete_Best	The_Best_(song)	Best_Buy
best but black friday	Black_Friday_(2004_film)	Brihanmumbai_Electric_Supply_and_Transport	Black_Friday	Black_Friday_(shopping)
best but laptops	The_Best_(song)	History_of_laptops	Laptop
walmart layaway	Walmart	Layaway
target layaway	Target_Corporation	Global_Handwashing_Day	Edmonton_Transit_System	Layaway
stores with layaway	Retail	Walmart	Layaway
walmart	Walmart	Criticism_of_Wal-Mart
costco	Cosco	Costco
target	Target_Corporation	Target_Field
existence god naturalism theory	Scientific_theory	God	Existence	Naturalism_(philosophy)	Existence_of_God
pink floyd the wall	Pink_Floyd_The_Wall_(film)	Pink_Floyd	Pink_Floyd_-_The_Wall	Pink_Floyd—The_Wall	The_wall
pink floyd the wall movie	Pink_Floyd_The_Wall_(film)	Pink_Floyd	Pink_Floyd—The_Wall	Pink_Floyd_-_The_Wall
bollywood legislation	Legislation	Censorship_in_India	Bollywood	Kollywood	Homosexuality_in_India
bollywood law	Bachelor_of_Laws	Bollywood	Islam_in_India
how to paint a car	Paint	The_Car_(painting)	How-to	Automobile
how to paint a car at home	Paint	How-to	Home	Automobile	Offshoring	Model_car
Vanuatu	Vanuatu
juventus streak ends	Primitive_streak	Streaking	Mineral	Juventus_F.C.
north korea rocket launch	North_Korea	Strategic_Rocket_Forces_(North_Korea)	Rocket	Rocket_launch
maria sharapova	Maria_Sharapova_career_statistics	Maria_Sharapova
heart rate	Heart_rate	Heart_rate_monitor
slow fast heart rate	Slow_(song)	Tachycardia	Heart_rate	Thinking,_Fast_and_Slow
further education for high school teachers	Further_education	Teacher	Secondary_education
crisis intervention	Crisis_intervention	Crisis_intervention_training	Therapeutic_Crisis_Intervention
crisis intervention prlsofessiona	Crisis_intervention	Therapeutic_Crisis_Intervention	Intervention_(counseling)
crisis intervention professional services	Crisis_intervention	Crisis_intervention_training	Professional_services
crisis intervention services	Service_(economics)	Crisis_intervention	Crisis_intervention_training
Merrill lynch Cheif exec	Bank_of_America	John_Thain	Get_Smart	Executive_officer	Merrill_Lynch
Merrill lynch	Bank_of_America_Merrill_Lynch	Merrill_Lynch
Merrill lynch headquarters	Bank_of_America_Merrill_Lynch	Headquarters	Merrill_Lynch
"russian politics" kursk submarine	Submarine	Politics_of_Russia	Russian_submarine_K-141_Kursk	Russian_submarine_Kursk_explosion	Russians
russia politics "kursk submarine"	Submarine	Russian_submarine_K-141_Kursk	Russian_Empire	Politics_of_Russia	Politics
yahoo movies	Yahoo!_Movies	Yahoo!
mom movie reviews	Film_criticism	Review	Teen_Mom	Film	Mother
epicurious	Epicurious	Epicurus
epic	Epic_(2013_film)	Epic	Epic_poetry
dr. ben carson	Gifted_Hands:_The_Ben_Carson_Story	Ben_Carson
bow ties	Bow_tie	Bow_tie_(biology)
consequences of hydroelectric dam	Dam	Environmental_impacts_of_dams	Hydroelectricity	Special_relativity
hydropower efficiency	Efficient_energy_use	Hydropower_Regulatory_Efficiency_Act_of_2013	Hydropower
round-trip v road-trip	Caleb_V._Haynes	Road_trip	USB
round-trip advantages versus road-trip	Banksy	Saccharomyces_cerevisiae	Road_trip	NBC_Sports_Network
round-trip enjoyable versus road-trip	Ichiro_Suzuki	Road_trip	NBC_Sports_Network	The_Prestige_(film)
round-trip enjoyable versus road-trip boring?	Bobby_Fischer	Boring,_Oregon	Road_trip	NBC_Sports_Network
gmail	Gmail/History	Gmail
gamil	Gamil_(Barcelos)	Gmail	Gamil	Gamil_(name)
samsung galaxy siii	Samsung_Galaxy_S	Samsung_Galaxy_SIII	Samsung_Galaxy_S_III
iphone 5	IPhone	IPhone_5
iphone5 rumors	IPhone	Rumor	IPhone_5
france world cup winners	UK_Championship_(snooker)	France_national_football_team	FIFA_World_Cup	KNVB_Cup	1998_FIFA_World_Cup
france 1998 final	1998_FIFA_World_Cup_Final	1998_FIFA_World_Cup	2010_FIFA_World_Cup_Final	France_national_football_team
france vs brazil 1998 stadium	Brazil	Rose_Bowl_(stadium)	Brazil_national_football_team	1998_FIFA_World_Cup_Final	Australia_31–0_American_Samoa	Stadium	France_national_football_team	1998_FIFA_World_Cup
good internet phone services	Voice_over_IP	Service_(economics)	Voice_over_Internet_Protocol	Good_(economics)	Internet
internet phone	Voice_over_IP	Mobile_phone	Internet
what's good about internet phoning	Phoning_home	What	Good_(economics)	Every_time_you_masturbate..._God_kills_a_kitten	Internet	What's_On
"what's good about internet phoning"	Phoning_home	Internet	Good_(economics)	What's_On
phone	Phone	Mobile_phone	Telephone	History_of_mobile_phones
phone internet	Mobile_phone	Telephone	Internet
phone internet providers	Internet_service_provider	Internet_Service_Provider	Telephone	Internet
good Voip	BroadVoice	Comparison_of_VoIP_software	Voice_over_IP	Product_(business)	VoIP
Voip reviews	Voice_over_IP	Review	IP_PBX	VoIP
michael jordan banned	Michael_B._Jordan	Michael_Jordan	Smoking_ban
kanye west deposed	Deposition_(politics)	Kanye_West_production_discography	Kanye_West
pocono mountains pennsylvania	The_Poconos	Pennsylvania	Pocono_Mountains	Pocono_Mountain_School_District
pocono mountains pennsylvania hotels	The_Poconos	Pennsylvania	Walt_Disney_World_Resort	Pocono_Mountains
pocono mountains pennsylvania things to do	Pennsylvania	Thing_(assembly)	The_Poconos	Pocono_Mountains	Doctor_of_Osteopathic_Medicine
pocono mountains camelbeach	The_Poconos	Pocono_Mountain_School_District	Camelbeach_Waterpark	Pocono_Mountains
pocono mountains camelbeach hotel	The_Poconos	Allegheny_Mountains	Action_Park	Hotel	Camelbeach_Waterpark
pocono mountains chateau resort	The_Poconos	Mountain_Lakes,_New_Jersey	Ski_resort	Château	Nemacolin_Woodlands_Resort
pocono mountains chateau resort attractions	Nemacolin_Woodlands_Resort	Alps	Château	The_Poconos	Ski_resort	Tourism
pocono mountains chateau resort getting to	Mountain_Lakes,_New_Jersey	Château	Main_Page	The_Poconos	Ski_resort	Getting_By
chateau resort getting to	Chateau	Ski_resort	Chateau_Lake_Louise	Château	Getting_By
pocono mountains chateau resort directions	Alps	Château	Main_Page	Directions_(PC_Quest_album)	The_Poconos	Ski_resort
"hospital anxiety and depression scale" scales references	Scale_(anatomy)	Geriatric_Depression_Scale	Hospital_Anxiety_and_Depression_Scale
"hospital anxiety and depression scale" scales "anxiety is"	Scale_(anatomy)	Hamilton_Anxiety_Scale	Anxiety	Hospital_Anxiety_and_Depression_Scale
detroit skate club	Detroit_Club	Ice_skating	Aaron_Parchem	Detroit	Nightclub
laurel park mall	Shopping_mall	Laurel_Park_Place	Park_Place_(Tucson,_Arizona)	Laurel_Mall_(Maryland)	Laurel_Park_Racecourse
cameras	Camera	Digital_camera
qvc	QVC_(UK)	QVC
pittsburgh paints	PPG_Industries	Pittsburg,_Texas
mohawk carpet	Mohawk_people	Mohawk_Industries	Sorona	Carpet
babies development "cultural differences"	Child_development	Infant	Babies	Cultural_identity
infant different developmental milestones depending on culture	Culture	Infant	Attachment_theory	Child_development	Developmental_milestones	Child_development_stages
developmental milestones infants "cultural differences"	Infant_development	Infant	Developmental_milestones	Cultural_identity	Child_development_stages
jobs from business phds	Doctor_of_Philosophy	Employment	The_Italian_Job_(2003_film)	Business
business phd	Doctorate	PhD_in_Management	Business_school	PhD
tsa	TSA_(band)	Transportation_Security_Administration	TSA
air travel information	Travel	Airliner	Information_technology	Air_travel
dick morris	Dick	Dick_Morris
breitbart	Breitbart	Andrew_Breitbart	Breitbart.com
swv	Greatest_Hits_(SWV_album)	SWV
home depot	The_Home_Depot	The_Home_Depot_Center
homemade halloween costumes	Halloween_costume	Halloween	Costume	HomeMADE
homemade pizza recipes	Recipe	HomeMADE	Pizza
homemade potato chips	Potato_chip	CHIP	HomeMADE	Potato
homemade pork sausage	Sausage_making	Pork	Sausage	HomeMADE
patio furiture	Garden_furniture	Patio
best cameras for concerts	Professional_video_camera	Greatest_hits_album	Camera	Concert
best cameras for photography	Digital_photography	Greatest_hits_album	Photography	Camera
jcpennys	JCPenney	J._C._Penney	James_Cash_Penney
cavenders boot town	Cowboy_boot	Boot	Cavenders	New_England_town
fat head sports	Sport	Head_(company)	Fat_head	Fat_Head
bieber won't be charged	Charge_(heraldry)	Justin_Bieber	Bieber,_California	South_Korean_won
Swahili dishes	Tableware	Swahili_culture	Swahili_language	List_of_African_dishes
traditional Swahili dishes	List_of_Christmas_dishes	Tableware	Swahili_culture	Swahili_language	Tradition
rocky balboa	Rocky_balboa	Rocky_Balboa_(film)	Rocky_Balboa
timothy mcveigh	McVeigh	Oklahoma_City_bombing	Timothy_McVeigh
terry nichols	Terry_Nichols	Terry_Pratchett
dan rather	Dan_Rather	Dan_Rather_Reports	Killian_documents_controversy
connie chung	Connie_Chung_Tonight	Connie_Chung
ellen degeneres	Ellen_DeGeneres	The_Ellen_DeGeneres_Show
louise lasser	Louise_Lasser	Louise_Redknapp
kristen wiig	List_of_awards_and_nominations_received_by_Kristen_Wiig	Kristen_Wiig
lmfao	Shots_(LMFAO_song)	LMFAO	LMFAO_(group)
m.i.a	M.I.A._(artist)	M.I.A._discography
christine o donnell	Chris_O'Donnell	Christine_O'Donnell
best snl hosts	Saturday_Night_Live	Presenter	List_of_Saturday_Night_Live_episodes	Saturday_Night_Live_hosts	Charles_Herbert_Best
new york governor patterson	New_York	George_W._Patterson	Governor_of_New_York	List_of_Governors_of_New_York	David_Paterson
the moon titan	Natural_satellite	Titan_(moon)	Moon
what is the longest running tv show	Running_(No_Doubt_song)	Wiki	List_of_longest-running_U.S._primetime_television_series	I_Want_to_Know_What_Love_Is	List_of_longest-running_United_States_television_series	Television_program
oksana baiul	Oksana	Oksana_Baiul
taboo black eye peas	Black_Eyed_Peas	The_Black_Eyed_Peas	Taboo_(rapper)
vanessa bayer	Vanessa_Bayer	The_Real_Thing_(Vanessa_Williams_album)
scarlett johansson	Scarlett_Johansson
example reference page	Web_page	Librarian	Exemplar	Reference	Wikipedia:Citing_sources
example reference page for resume	Cover_letter	Page_(paper)	Exemplar	Reference	Résumé
how many references on a resume	Résumé	Reference	Resume
concord nc zip code	Charlotte_metropolitan_area	Concord,_North_Carolina	ZIP_code
capitalone.com	Component_Object_Model	Capital_One_Cup	Capital_One
subway menu	Menu	Subway	Subway_(restaurant)
bbc sherlock episodes	Episodes_(TV_series)	BBC	List_of_Sherlock_episodes	Sherlock_(TV_series)
low carb high fat diet	Diet_(nutrition)	Low-carbohydrate_diet	Low-fat_diet
list of diets	List_of_diets	Diet_(nutrition)	List_of_vegetables	Party-list_proportional_representation	Diet_(assembly)
allspice berries	Allspice	Berry
cloves spice	Clove	Allspice	Spice_mixture	Spice
kohls	Kohl's
cranberry sauce	Cranberry_sauce	Cranberry
turkey breast recipes	Poultry	Domesticated_turkey	Recipe	Turkey_(food)	Turkey_(bird)
youtub	Youtube	YouTube	List_of_YouTube_personalities
inuyasha	List_of_InuYasha_characters	InuYasha
inuyasha games	The_Legend_of_Zelda	InuYasha:_Feudal_Combat	InuYasha
cocker spaniel	Cocker_Spaniel	English_Cocker_Spaniel
masters 7 cinemas	Master_Cleanse	Master_of_Puppets	Master's_degree	Movie_theater
under the dome	Under_the_Dome_(TV_series)	Under_the_Dome
goodwin games	Talk:The_Goodwin_Games	The_Goodwin_Games
diamantopoulos	Diamantopoulos	Chris_Diamantopoulos	Giorgos_Diamantopoulos
into the woods	Into_the_Woods_(film)	Into_the_Woods	Wood	The_Cabin_in_the_Woods
jackson hurst	Michael_Jackson	Jackson_Hurst
kursk russian sinking	Russian_submarine_Kursk_explosion	Last_battle_of_the_battleship_Bismarck	Russian_submarine_K-141_Kursk	Kursk	Russians
kursk russian sinking US submarines	Submarine	Last_battle_of_the_battleship_Bismarck	Russian_Empire	Kursk_submarine_disaster	Russian_submarine_Kursk_explosion	Russian_submarine_K-141_Kursk	Battle_of_Kursk
where do marsupials keep their young	The_Keep_(film)	Monotreme	Thomas_Young_(scientist)	Denominación_de_Origen	Marsupial
non-extinct marsupials	Monotreme	Largest_mammals	Marsupial
"non-extinct" marsupials	Monotreme	Largest_mammals	Marsupial
marsupials	List_of_monotremes_and_marsupials_of_Australia	Marsupial
largest meat eating marsupial	Horse_meat	Carnivore	Dog_meat	Meat	Marsupial_Lion	Marsupial
marsupial outside australia	Outside_(George_Michael_song)	Australia	Marsupial_Lion	Kangaroo	Marsupial
marsupial manure	Perth_Zoo	Feces	User:Tooholli	Marsupial
"marsupial manure"	Feces	User:Tooholli	Marsupial
marsupial cartoon character	Cartoon	Character_(arts)	Cartoon_pornography	Tasmanian_Devil_(Looney_Tunes)	Marsupilami	Marsupial
yahoo mail	Yahoo!_Mail	Yahoo!
gun control	Gun_politics_in_the_United_States	Gun_control
gun control violence	Gun_violence	Violence	Gun_control
does gun control reduce gun violence	Gun_violence	Gun_control	Redox
Indian wedding rituals	Hindu_wedding	Ritual	South_Asian_wedding	Indian_wedding	Wedding
Indian wedding customs	Hindu_wedding	South_Asian_wedding	Wedding_customs_by_country	Wedding
when france win world cuo	2006_FIFA_World_Cup	Victory	France_at_the_FIFA_World_Cup	France_national_football_team	FIFA_World_Cup	1998_FIFA_World_Cup
when france win world cup	2006_FIFA_World_Cup	Victory	France_at_the_FIFA_World_Cup	France_national_football_team	FIFA_World_Cup	1998_FIFA_World_Cup
france versus who world cup 1998	The_Who	NBC_Sports_Network	France_national_football_team	1998_FIFA_World_Cup_Final	1998_FIFA_World_Cup
france versus who world cup 1998 final score	The_Who	NBC_Sports_Network	France_national_football_team	1998_FIFA_World_Cup_Final	Final_Score	1998_FIFA_World_Cup
nickname for france football team in world cup 1998	France_national_football_team	Football_World_Cup_1998	France_national_under-20_football_team	Nickname	1998_FIFA_World_Cup
stadium final world cup 1998	1998_FIFA_World_Cup_Final	2011–12_ISU_Speed_Skating_World_Cup_–_World_Cup_Final	Stadium	1998_FIFA_World_Cup
coach france football team world cup 1998	Coach_(sport)	1998_FIFA_World_Cup	1998_FIFA_World_Cup_squads	France_national_football_team
movie theaters kalamazoo mi	Atmospheric_theatre	Kalamazoo,_Michigan	Movie_theater
portage ymca	Portage,_Indiana	Barrie	YMCA	Ignace
intersection grand rapids	Intersection_(road)	Grand_Rapids,_Minnesota	Grand_Rapids,_Michigan
jw marriott grand rapids	JW_Marriott_Grand_Rapids	Marriott_International	JW_Marriott_Hotels
gagie school kalamazoo	Kalamazoo,_Michigan	Kalamazoo_College	Catholic_school
bruno mars treasure	Bruno_Mars	Treasure	Treasure_(Bruno_Mars_song)
all recipes	Allrecipes	Recipe
all recipes lasagna	Lasagne	Bolognese_sauce	Recipe	Lasagna
lumineers stubborn love video	The_Lumineers_discography	HMS_Stubborn_(P238)	Stubborn_Love	The_Lumineers	Music_video	Romance_(love)
join job corp	Corporation	Process_(computing)	Peace_Corps	Joinder	Joint
join job corps	Joint	Join_(SQL)	Peace_Corps	Job_Corps
gemini compatibility	Computer_compatibility	Project_Gemini	Gemini	Gemini_(astrology)
amazon	Amazons	Amazon	Amazon.com
dancing with the stars	Dancing_With_The_Stars	Dancing_with_the_Stars_(U.S._TV_series)	Dancing_with_the_Stars
nurses sue douglas kennedy	Douglas_MacArthur	Jacqueline_Kennedy_Onassis	Nursing	Sue_Douglas	Douglas_Kennedy_(actor)
aetna	Aetna	Etna
stigma	Stigma	Stigmata	Social_stigma
uis	Uis	User_interface
philadelphia eagles	Philadelphia_Eagles	2009_Philadelphia_Eagles_season
cowboys fans petition obama	Dallas_Cowboys	Fan_(person)	Petition	Barack_Obama
girl slept for 64 days	Sleep_deprivation	Girl	Sleep
selena in emergency room	Emergency_department	Selena
comcast	Comcast	Comcast_business
cheap dsl providers	Internet_service_provider	Internet_in_Germany	Cheap_(ward)	Digital_subscriber_line
katy perry skintight ballot	Ballot	Teenage_Dream_(Katy_Perry_song)	Katy_Perry	Skin-tight_garment
jack nicholson imdb	Internet_Movie_Database	List_of_Jack_Nicholson_films	Jack_Nicholson
jack nicholson co stars	Jack_White	Nicholson_&_Co_(Worcester)_Ltd	Movie_star	Jack_Nicholson
jack nicholson  and his co stars	Jack_nickelson	Colorado	Jack_Black	Celebrity	Jack_Nicholson
co stars of jack nicholson	Celebrity	Colorado	Jack_Nicholson_filmography	Jack_Nicholson
jack nicholson	Jack_Nicholson
elizabeth essex	Elizabeth_I_of_England	Robert_Devereux,_2nd_Earl_of_Essex	Essex_County,_New_Jersey	The_Private_Lives_of_Elizabeth_and_Essex
skate america 2012	American_football	2012_Skate_America	Skate_America	2012
international sports	International	Sport	List_of_international_sport_federations	International_Baccalaureate
universal sports schedule	Universal_Studios	Broadcast_programming	Universal_Sports
redsox	Red_Sox_Nation	Boston_Red_Sox
spokesman	Spokesperson	Spokesman	The_Spokesman-Review
dust in the wind youtube	Dust_in_the_Wind	Dust_storm	Kansas_(band)	YouTube
davenport lyons	Talk:Davenport_Lyons	Davenport_Lyons
bradley cooper	Bradley_Cooper	Bradley_Cooper_(athlete)
copa airlines	Copa_Airlines
united airlines	United_Airlines	United_Airlines_Flight_93
missing girl dragged by hair	Drag_and_drop	Missing_(Everything_but_the_Girl_song)	Missing_white_woman_syndrome	Hair_(musical)	Girl	Look_What_the_Cat_Dragged_In
cargo pants	Cargo_pants	Fashion_accessory	Pants
dockers slacks	Dockers	Haggar_Clothing	Trousers
kristen stewart desperate	Kristen_Stewart	Desperate_(Divinyls_album)
where is area code 503	Area_code_360	Area_codes_503_and_971	Area_code_503
where is area code 503 located	Area_code_205	Area_codes_503_and_971	Area_code_503
spinal stenosis	Lumbar_spinal_stenosis	Spinal_stenosis
lumbar spinal stenosis	Lumbar_spinal_stenosis	Spinal_stenosis
human barbie	Human_Barbie	Barbie_doll	Human	Barbie
hoboken estates	Joseph_Barry	Hoboken_Elevated	Hoboken,_New_Jersey	Hoboken_Land_and_Improvement_Company_Building	Estates_of_the_realm
hoboken map	Map	Hoboken_Terminal	Hoboken,_New_Jersey	Hoboken–33rd_Street_(PATH_service)
oprah life class	Life_class	Oprah_Winfrey	The_Oprah_Winfrey_Show	Oprah's_Lifeclass
ted	TED	TED_(conference)	Ted_(film)
calcium in water	Water	Calcium	Calcium_carbonate	Hard_water
calories in egg whites	Egg_white	Egg_(food)	Calorie
strength training vs cardio	Strength_training	Weight_training	Vs._(Pearl_Jam_album)	Aerobic_exercise
ritz restaurant newport beach	Hôtel_Ritz_Paris	Ritz-Carlton	Newport_Beach,_California	Restaurant
pascal restaurant newport beach	Newport_Beach,_California	Beach	Pascal_(unit)	Restaurant
five crowns corona del mar	Five_Crowns	Del_Mar,_California	Corona_del_Mar,_Newport_Beach	Corona_del_Mar
skype	Skype
skype for mac	Mac_OS	Skype_Technologies	Skype
poker vegas	Poker	Las_Vegas_Valley	World_Series_of_Poker
poker atlantic city	Poker	Atlantic_City_(1980_film)	Atlantic_City,_New_Jersey
775 area code	Telephone_numbering_plan	Area_code_725	Area_code_775
hsv 2	HSV-2_Swift	Herpes_simplex_virus	HSV-2
wet n wild anthony	Anthony_(film_editor)	Wet_'n_Wild	Wet_'n_Wild_Orlando	Wet_'n_Wild_(United_States_water_park_chain)	Wet_N'_Wild_Waterworld
el paso outlet mall	Cielo_Vista_Mall	Template:El_Paso_malls	Outlet_store	El_Paso,_Texas
el paso malls	Shopping_mall	Cielo_Vista_Mall	Template:El_Paso_malls	El_Paso,_Texas
spanish province	Province	Spanish_Empire	Spanish_language	List_of_Spanish_provinces_by_population	Provinces_of_Spain
blaze you out trailer	You_(Lloyd_song)	In_&_Out	Blaze	Trailer_(promotion)	Fire	TheBlaze
gloating	Bloating	Gloating	Gloat
us political map	Government	Political_corruption	Political_geography	United_States_dollar
us geographic map	Map	Georeference	Geographic_information_system	Map_projection	United_States_dollar
Iraqi defector Curveball details	Defection	Details_(magazine)	Curveball_(informant)	Iraq_War	Iraq_and_weapons_of_mass_destruction
Curveball wiki	Wiki	Curveball_(informant)	Curveball
facebook.com	History_of_Facebook	Facebook
youtube	Youtube	YouTube	List_of_YouTube_personalities
girl chained to dresser dies	Chained_(Marvin_Gaye_song)	Death	The_Dresser	The_Girl_(2000_film)
Girl chained to dresser dies	Chained_(Marvin_Gaye_song)	Death	The_Dresser	The_Girl_(2000_film)
clinton falls asleep	Clinton_Falls,_Minnesota	Sleep	Asleep	Clinton_Falls_Township,_Steele_County,_Minnesota
mayim bialik divorce	Divorce	Mayim_Bialik
clarity nails salem nh	Clarity_(Jimmy_Eat_World_album)	Salem,_New_Hampshire	Nail_(fastener)
white house down movie	House_(TV_series)	White_house	Down_(film)	White_House	Feature_film	White_House_Down
loews theater methuen ma	Methuen,_Massachusetts	Theatre	Loews_Cineplex_Entertainment	Theatre_of_ancient_Greece
lawrence movie theaters	Joey_Lawrence	Nickelodeon_(movie_theater)	Movie_theater	D._H._Lawrence
reliefs inn lawrence ma	Inn	Lawrence,_Massachusetts	Salbutamol	Relief	Astrology
yahoo	Yahoo!
ebay	Criticism_of_eBay	EBay
Port Arther Massacre	Port_Arthur_massacre	Port_Arthur_massacre_(Australia)
Port Arther Massacre Australia	Port_Arthur_massacre	Port_Arthur_(Australia)	Port_Arthur_massacre_(Australia)	Australia
Port Arther Massacre Australia names died	Port_Arthur,_Tasmania	Australia	Egypt	Port_Arthur_(Australia)	Port_Arthur_massacre_(Australia)
Port Arther Massacre Australia victims names	2011_Tucson_shooting	Australia	Egypt	Martin_Bryant	Port_Arthur_massacre_(Australia)	Gun_politics_in_Australia
facebook obama slur	Facebook	Barack_Obama	Barack_Obama_on_social_media	Pejorative
Facebook Obama slur	Facebook	Barack_Obama	Barack_Obama_on_social_media	Pejorative
lee macphail dies	Lee_MacPhail	Die_(manufacturing)	Bruce_Lee
"jeopardy game show"	Watson_(computer)	Jeopardy_(song)	Jeopardy!	Game_show
"jeopardy game show" history	Watson_(computer)	Jeopardy!_broadcast_history	Jeopardy_(song)	Game_show	History_(TV_channel)	Jeopardy!
soralfun	
evergreen	Evergreen	Evergreen_Marine
cntf	ZFP91-CNTF	CNTF	Neurotrophic	Ciliary_neurotrophic_factor	Confédération_nationale_du_travail
girl fatally shot on school bus	Girl	Shooting	School_bus
macho camacho critical	Hector_Camacho_Jr.	Héctor_Camacho	Critical_mass	Camacho_(wrestler)
price is right model wins suit	Model_(person)	Prince_(musician)	List_of_The_Price_Is_Right_pricing_games	The_Price_Is_Right	WINS_(AM)	Suit_(clothing)
honey boo boo made of trash	Honey	Waste_container	Boo-Boo_Bear	Here_Comes_Honey_Boo_Boo
wanda jackson	Wanda_Jackson_albums_discography	Wanda_Jackson
how many calories in a banana	Calorie	Banana	BANANA
how much water to drink daily	Água_de_Beber	Newspaper	Water	Drinking_water
how to tie a tie	Tie-in	The_85_Ways_to_Tie_a_Tie	Necktie	How-to
yahoo! horoscopes	Virgo_(astrology)	Horoscope	Yahoo!
how many cc in a ml	Litre	Shot_glass	Master_of_Laws	Cubic_centimetre
how many ccie in the world	World	CCIE_Certification	Cisco_Career_Certifications
anchors resign on air	On-air_resignations	Broadcasting	Glossary_of_chess	Anchor	Anchors
mrsa infection	Methicillin-resistant_Staphylococcus_aureus	Mrsa	Infection
chamber of commerce charleston sc	Chamber_Music_Charleston	Charleston,_South_Carolina	Chamber_of_commerce
jicama	Pachyrhizus	Jícama	Pachyrhizus_erosus
sumac	Sumac	Sumac_(band)	Yma_Sumac
facebook log in	Login	Facebook_Home	Facebook
montana lottery	Montana_Lottery	California_State_Lottery
fargo forum	Fargo_Forum	Template_talk:Wells_Fargo	The_Forum_of_Fargo-Moorhead	Forum
grand forks herald	Grand_Forks,_North_Dakota	Grand_Forks_Herald
lawrence guyot dies	Lawrence_Guyot	T._E._Lawrence	Die_(manufacturing)	Lawrence_v._Texas
billings gazette online	Billings,_Montana	E-learning	Billings_Gazette	The_Billings_Gazette
phd business jobs	PhD_in_management	Doctorate	Doctor_of_Philosophy	Steve_Jobs	PhD_in_Management
phd business salaries	Salary	Doctorate	PhD_in_management	PhD_in_Management
business phd funding	Doctorate	Funding	PhD_in_Management	Business
business phd vs masters	Master_of_Business_Administration	Cognac	Master's_degree	Business_school	Doctorate
business phd duration	Doctorate	Doctor_of_Philosophy	PhD_in_Management	Business	Time
business phd income	Unrelated_Business_Income_Tax	Doctorate	Business	Income
earn money at home	Money	Homeschooling	Make_Money_Fast	Work-at-home_scheme	Home
earn money at home scam	Home_insurance	Make_Money_Fast	Money	Homeschooling	Confidence_trick	Work-at-home_scheme
dulles airport	Dulles	Washington_Dulles_International_Airport	Dulles_Airport
dulles airport location	Filming_location	Washington_Dulles_International_Airport	Dulles,_Virginia
dulles hotels	Walt_Disney_World_Resort	B._F._Saul_Company	1992_Yemen_hotel_bombings	Washington_Dulles_International_Airport	Dulles_Airport
dulles metro stop	Washington_Metro	Tram_stop	Silver_Line_(Washington_Metro)	Washington_Dulles_International_Airport
dog heat stroke symptoms	Hyperthermia	Heat_stroke	Symptom
dog heat illnesses	List_of_dog_diseases	Heat	Illness	Dog	Heat_illness
walmart black friday ad	Wal-Mart	Walmart	Advertising	Black_Friday_(shopping)
hu jintao steps down	Down_GAA	Steps_(group)	Hu_Jintao	Jiang_Zemin
Churchill downs schedule	Schedule_(computer_science)	Churchill_Downs_Incorporated	Churchill_Downs
Churchill downs race schedule 2013	Horse_racing	Churchill_Downs	Schedule_(workplace)	2013_Kentucky_Derby
Churchill downs seating	Churchill_Downs_Incorporated	Churchill_Downs	Seating_capacity
Churchill downs Kentucky derby museum	Churchill_Downs	Kentucky_Derby_Museum
craigslist	Craigslist	Craigslist_Joe
autotrader	AutoTrader.com	Auto_Trader
yahoo! axis	Yahoo!_Axis	Yahoo!
costco	Cosco	Costco
target	Target_Corporation	Target_Field
145 pounds in kg	Mixed_martial_arts_weight_classes	Pound_(mass)	Kilogram
sodexo email	Employee_benefit	Email	Sodexo	La_Poste_(France)
subaru forester 2014	Subaru	Subaru_Forester
houstonzoo.org	Houston_Zoo	.org	File:Houston_Zoo_logo.svg
yahoo finance search	Web_search_engine	Yahoo	Yahoo!
coaching speech	Coaching	Public_speaking	Jim_Valvano	Moe_Berg
cs monitor	CRT_monitors	CS_Monitor	The_Christian_Science_Monitor
baggage restrictions	Baggage	Regulation	Hand_luggage	Luggage
carry-on liquid restrictions	Market_liquidity	Regulation	Hand_luggage	2006_transatlantic_aircraft_plot_security_reaction
earthquake hits japan	Japan	Japan_earthquake_2011	Hits+	Earthquake	Japan_earthquake
glass blowing	Glass	Glassblowing
glass blowing science	Science	Glassblowing	Glass_Science
scientific glass blowing	Glass	Scientific_revolution	Glassblowing	Scientific_glassblowing	Venetian_glass
pascual perez killed	Pascual_Pérez_(boxing)	Death_of_Osama_bin_Laden	Pascual_Pérez_(baseball)
proposition 30 california 2012	California	Referendum	California_Proposition_30_(2012)	California_Proposition_37_(2012)
bass pro shoppe	Bass_Pro_Shops	Professional_sports	Bass_(fish)	Bass_Pro_Shops:_The_Strike	The_Shoppe
"skagit valley herald"	The_Herald_(Everett)	Skagit_Valley	Sage_Rosenfels	Burlington,_Washington
skagitvalleyherald.com	Component_Object_Model
www.skagitvalleyherald.com	Component_Object_Model	World_Wide_Web
"skagit valley herald" created	Lake_County_Examiner	The_Herald_(Everett)	Glenn_Beck	Skagit_Valley
"skagit valley herald" founded	Skagit_Valley_Hospital	The_Herald_(Everett)	Glenn_Beck	The_Herald_Journal	Skagit_Valley
"skagit valley herald" circulation	The_Herald_Journal	The_Herald_(Everett)	List_of_newspapers_in_the_United_States	Skagit_Valley	Periodical_literature
"skagit valley" demographics	Skagit_County,_Washington	Skagit_Valley	Oregon
"skagit county"	Skagit_County,_Washington	Mount_Vernon,_Washington
"skagit valley" noted	Glenn_Beck	Skagit_Valley	Skagit_County,_Washington
"skagit valley" history	History_(TV_channel)	Skagit_County,_Washington	Skagit_Valley	Skagit_River
safeyouth.org	.org
teen dating violence	Dating_abuse	Dating	Teen_dating_violence
first partial face transplant	World_War_I	Isabelle_Dinoire	Face_transplant	Partial_differential_equation
isabelle dinoire criticisms	Egalitarianism	Tesco_Ireland	Isabelle_Dinoire
isabelle dinoire ethics	Ethics	Isabelle_Dinoire	Myers-Briggs_Type_Indicator
perez hilton	Perez_Hilton	Paris_Hilton
42 years in a coma	Coma	Elaine_Esposito
rihanna and chris brown	Rihanna	Chris_Brown_(entertainer)	Chris_Brown_(American_entertainer)	Chris_Brown
monica potter	Monica_Potter	Monica_(given_name)
yahoo! dating	Online_dating_service	Dating	Yahoo!_Answers	Yahoo!
the benefits of exploration space	Space	Space_exploration	Outer_space	Welfare
the benefits of "exploration space"	Satellites	Colonization_of_Mars	Space_exploration	Outer_space	Welfare
gps receivers	GPS_receiver	Global_Positioning_System
digital cameras gps	Global_Positioning_System	Digital_camera	Geotagged_photograph
2013 accord	SportAccord	Honda_Accord
2013 altima recall	Recall_election	Nissan_Altima
2013 altima sedan	Sedan_(automobile)	Nissan_Teana	Nissan_Altima
honda 2013 accord sedan	Sedan_(automobile)	Honda	Honda_Accord_(North_America_eighth_generation)	Honda_Accord
2013 accord sedan	Sedan_(automobile)	Honda_Accord_(North_America_eighth_generation)	Honda_Accord
2013 accord sedan	Sedan_(automobile)	Honda_Accord_(North_America_eighth_generation)	Honda_Accord
2013 accord sedan photos	Photograph	Honda	Sedan_(automobile)	Honda_Accord
2013 kia optima	Kia_Optima	Kia_Sportage
2013 rav4	Rav4_ev	Toyota_RAV4
2013 equinox	Equinox	Chevrolet_Equinox
2013 lacrosse buick	Lacrosse	Buick_LaCrosse	Buick
2013 taurus	Taurus_(constellation)	Ford_Taurus	Ford_Taurus_(sixth_generation)
2013 camry	Toyota_Camry_(XV50)	Toyota_Camry
2013 camry redesign	Lexus_ES	Design	Toyota_Camry
2013 mazda cx5	Mazda_CX-9	Mazda_CX-5
2013 mustang	Mustang_horse	File:2013_Mustang_V6_Performance_Package_blueck.jpg	Ford_Mustang
2013 malibu	Malibu	Chevrolet_Malibu	Malibu,_California
2013 malibu pictures	Malibu_(film)	Malibu,_California	Film	Chevrolet_Malibu
2013 malibu price	Malibu_Comics	Piper_PA-46	The_Price_(comics)	Chevrolet_Malibu
Pseudocyesis wiki	Wiki	Pseudocyesis	Talk:Pseudocyesis	False_pregnancy	Psychodynamic
Pseudocyesis pregnancy wiki	Wiki	Pseudocyesis	Talk:Pseudocyesis	Pregnancy	False_pregnancy
parts american standard	Paper_size	American_Standard_Brands	United_States	ASCII
wall hung kohler	Berlin_Wall	WALL-E	Horst_Köhler	Kohler_Company	Hanging
facebook	History_of_Facebook	Facebook
www.jetairways.com	Jet_Airways	Jet_Airways_destinations	World_Wide_Web
printable maps	Map	Mind_map	Graphic_character
atlas	Atlas	Atlas_(mythology)
US civil war causes	American_Civil_War	Origins_of_the_American_Civil_War	Paralysis	Civil_war
US civil war economic  causes	American_Civil_War	Causality	Economy_of_the_United_States	Origins_of_the_American_Civil_War	Civil_war
bollywood facts	Bollywood/Hollywood	Bollywood	Fakty_TVN
bollywood oscars	Academy_Award	List_of_Indian_submissions_for_the_Academy_Award_for_Best_Foreign_Language_Film	Bollywood	Academy_award
face transplant	Talk:Face_transplant	Face_transplant
finished the task	Examen_artium	Task_(computing)	Task_management	Task_(project_management)
sunbeam mixmaster	Mixer_(cooking)	Sunbeam_Products	Sunbeam_Australia
powerball closing time	Closing_Time_(album)	Powerball	Closing_Time_(Semisonic_song)	Closing_Time_(Doctor_Who)
horse hooves care and treatment	Horse_hoof	Shuangbaotai	Therapy	Health_care	Horse_care
horse hooves	Shuangbaotai	Horse_hoof	Hooves	Shoeing_(horses)
swahili dish	The_Dish	List_of_African_dishes	Swahili_culture	Swahili_language
swahili dish kenya picture	Culture_of_Kenya	Swahili_language	Dish_Network	Kenya	Parabolic_antenna	Film
hangul	Hangul_Day	Hangul	Kashmir_stag
korean language	Korean_language	Korea	Hangul
cnnsi	CNN	CNNSI	Cyrille_Mangan	CNN_Sports_Illustrated
espn	ESPN+	ESPN
high heart rate blood pressure cholesterol	Blood_pressure	Heart_rate	Hypertension	High_blood_pressure	Cholesterol
high heart rate	Substance_intoxication	Heart_rate	Tachycardia
pocono mountains	The_Poconos	Pocono_Mountain_School_District	Pocono_Mountains
pocono mountains park	The_Poconos	Pocono_Mountain_School_District	Park	Pocono_Mountains
pocono mountains shopping	The_Poconos	Shopping_mall	Pocono_Mountains	Pocono_Mountain_School_District
volvo	Volvo_P1800	Volvo
volvo semi trucks	Volvo_Trucks	Semi-trailer_truck
working mechanism of water turbines	Water_turbine	Antikythera_mechanism	Working_memory	Steam_engine	Mechanism_(engineering)	Wind_turbine
types of water turbines	Water_turbine	Steam_turbine	Wind_turbine	Switched-mode_power_supply
newtons laws on water turbines	Water_turbine	Newton's_laws_of_motion	Lift_(force)
pseudocyesis	False_pregnancy	Psychodynamic	Pseudocyesis
pseudocyesis epidemiology	Epidemiology	False_pregnancy	Pseudocyesis	Pregnant
pseudocyesis history	Pseudocyesis	False_pregnancy	User:Savanahd	Psychodynamic	History
kcs	Kansas_City_Southern_Railway	Knowledge_Centered_Support	Southern_Belle_(KCS_train)
kcs petrohawk	Kansas_City_Southern_Railway	Petrohawk
"history of face transplants"	List_of_Horizon_episodes	Organ_transplant	Face_transplant	History
weeworld	List_of_social_networking_websites	WeeWorld
venture capital	List_of_venture_capital_firms	Venture_capital
loans for entrepreneurship	Loan	Mortgage_loan	Entrepreneurship
loans for entrepreneurship switzerland	Switzerland	Loan	Mortgage_loan	Entrepreneurship
loans for business	Loan	Payday_loan	Business
loans for business us government	Loan	Mortgage_loan	Federal_government_of_the_United_States	Business
renting a building business sillicon valley	Renting	Building	Business	San_Fernando_Valley	Silicon_Valley
renting an office sillicon valley	Renting	Silicone	Silicon_Valley	Office
becoming dj	Disc_jockey	Becoming_(Buffy_the_Vampire_Slayer)
dj jobs	DJ_Sneak	Disc_jockey	Job_(role)
wedding shower theme ideas budget	Film_budgeting	Wedding	Bridal_shower	Theme_music	Idea	Baby_shower
wedding shower ideas	Bridal_shower	Ideas_(radio_show)	Baby_shower
alan greenspan	Alan_Greenspan	Greenspan
longest serving Federal Reserve Chairman	List_of_Chairmen_of_the_Federal_Reserve	Alan_Greenspan	Chairman_of_the_Federal_Reserve	Federal_Reserve_System	William_McChesney_Martin
anne hathaway	Anne_Hathaway	Anne_Hathaway_(Shakespeare's_wife)
Anne Hathaway	Anne_Hathaway	Anne_Hathaway_(Shakespeare's_wife)
$425 million jackpot	Lottery_jackpot_records	Million	Prize	Mega_Millions
woodsman stain	Staining	The_Woodsman	Chainsaw	Benjamin_Bratt
sikkens deck stain	Skateboard	AkzoNobel	Wood_stain
connecticut fire academy	Wildfire	Connecticut	National_Fire_Academy	Arkansas_Fire_Academy	Academy	Manchester,_Connecticut
connecticut fire department	Bridgeport_Fire_Department	Connecticut	New_York_City_Fire_Department	Bristol,_Connecticut_Fire_Department
gangnam video	Gangnam_Style_(music_video)	Gangnam-gu	Video	Gangnam_Style
hardees	Hardee's	Hardee_Apartments	Billy_Hardee	Hardee
hardees corporate offices	Corporate_office	Corporation	Hardee's	Office
pandora	Pandora_Hearts	Pandora
tufts.edu	Edward_Tufte	.edu	Tufts_University
ideas for college care packages	Career	CARE_Package	Secondary_education_in_France	Idea	Health_care
pampered chef	The_Pampered_Chef	Farina_(food)
hosting pampered chef	Jay_Christopher	The_Pampered_Chef	Web_hosting_service
cosmopolitan	Cosmopolitanism	Cosmopolitan_(cocktail)	Cosmopolitan	Cosmopolitan_(magazine)
buy used car parts online	Internet	Used_car	Automobile	List_of_auto_parts	Trade
junk yard	Wrecking_yard	Junkyard	Junkyard_(band)	Junkyard_Dog
History of DSEC	DiSEqC	F_connector	Economy_of_Macau	History
History of dupont science essay contest	Essay	Dream_Deferred_Essay_Contest	DuPont	Dartmouth_Undergraduate_Journal_of_Science	Science	Competition	History
the secret garden	Secret_Garden_(TV_series)	The_Secret_Garden	The_Secret_Life_of_the_American_Teenager	Garden
biography burnett	Smiley_Burnette	Carol_Burnett	List_of_albums_produced_by_T-Bone_Burnett	Biographical_film	Frances_Hodgson_Burnett
pocono resort	The_Poconos	Ski_resort	Penn_Hills_Resort
skytop lodge directions	Edward_Okuń	Masonic_Lodge	Directions_(PC_Quest_album)	Main_Page	Skytop,_Pennsylvania
Philidelphia car rental	National_Car_Rental	Philadelphia	Car_rental
vldl levels	GCE_Advanced_Level	Very_low-density_lipoprotein	Low-density_lipoprotein	VLDL
difference vldl ldl hdl	VLDL	Cadency	LDL	Very_low-density_lipoprotein	High-density_lipoprotein
facebook	History_of_Facebook	Facebook
sun spot activity	Sun	Sunspot	Solar_variation	Radioactive_decay
sun spot earthquake	Sun	Sunspot	Earthquake
wonderware midwest	Wonderware	Midwestern_United_States
sswc	Single_Speed_World_Championship	Surly_Bikes
google	Google_Earth	Google
psd401	Peninsula_High_School
pseudocyesis	False_pregnancy	Psychodynamic	Pseudocyesis
pseudocyesis causes	Etiology	False_pregnancy	Psychodynamic
pseudocyesis causes new research	Etiology	False_pregnancy	Psychodynamic	Medical_research
causes of false preganancy	Etiology	False_pregnancy	Pregnancy_test
john elway dodge greeley	John_Elway	John_Kerry	Dodge_County,_Georgia	Greeley,_Colorado
craigslist	Craigslist	Craigslist_Joe
mapquest	MapQuest	Manure
shoulder joint pain	Shoulder	Arthralgia	Glenohumeral_joint	Shoulder_problem	Shoulder_pain
shoulder joint pain nhs	National_Health_Service	Arthralgia	Glenohumeral_joint	Shoulder	Shoulder_problem
yahoo! axis	Yahoo!_Axis	Yahoo!
adele baby	Adele_Enersen	Adele	Baby_(Justin_Bieber_song)	Adele_(singer)
adventure time	Adventure_Time	List_of_Adventure_Time_Episodes
adventure time hat	Hat	Adventure_Time
rule 34	Rule_34_(Internet_meme)	Golden_Rule	34_(number)	Ja_Rule
face transplants	Organ_transplant	Face_transplant
windows spyware	Microsoft_Windows	Spyware	Windows_Defender
defender problems	Defender_(association_football)	Public_defender	Land_Rover_Defender
usaa	USAA	USA_Today	Stockholm
new sexiest man alive	People_(magazine)	My_Sexiest_Year	Sexiest_Man_Alive
heart attack details	Heart_Attack_(Demi_Lovato_song)	Myocardial_infarction	Details_(magazine)
heart attack	Myocardial_infarction	Heart_attack_(disambiguation)	Heart_attack
heart attack statistics	Myocardial_infarction	Statistics	Heart_attack_(disambiguation)	Heart_attack
the bachelor	Bachelor	The_Bachelor_(TV_series)	The_Bachelor_(U.S._TV_series)
the east	East_India_Company	East	Eastern_world	East_Timor
game of thrones	Game_of_Thrones_(TV_series)	Game_of_Thrones_(season_4)	Game_of_thrones
tool	Tool	Tool_(band)	Diagnosis
steve guttenberg	Steve_Guttenberg
redbox	Red_box	Redbox
caddo lake texas	Caddo	Caddo_Lake	Texas
rick warren	Warren_Buffett	Rick_Warren
rick warren debate	Warren_Buffett	Debate	Rick_Warren
downtown san antonio map	Map	Downtown_San_Antonio	San_Antonio
best elliptical trainers for home use	Greatest_hits_album	Trainer_(aircraft)	Treadmill	Home_(Michael_Bublé_song)	Elliptical_trainer	Elliptical_wing
elliptical trainers	Trainer_(aircraft)	Arc_Trainer	Elliptical_wing	Elliptical_trainer
tour bus	Tour_bus_service	Double-decker_bus	Tour_bus	Bus
events ideas students community	Festival	Learning_community	Idea	Community	Student_Society_in_Trondheim
events ideas student association	Syracuse_University	Association_of_Ideas	Sport	Idea	European_Pharmaceutical_Students'_Association
developmental milestones infants	Infant_development	Infant	Developmental_milestones	Child_development_stages
developmental milestones infants 0-12 months	Infant_development	Infant	Developmental_milestones	Child_development_stages
developmental milestones infants east asia	Wikipedia:Milestones	East_Asia	Infant	Child_development_stages	Child_development
developmental milestones east asia	East_Asia	East_Asia_Development_Board	Child_development_stages
"developmental milestones in east asia"	East_Asia	History_of_modernisation_theory	Child_development_stages	Milestone
developmental milestones asian infants	Infant_development	Infant	Developmental_milestones	Asian_people	Child_development_stages
asian infants	Infant_massage	Minor_(law)	Mongolian_spot	Asian_people
asian infants milestones	Wikipedia:Milestones	Developmental_milestones	Minor_(law)	Child_development_stages	Asian_people
asian infants development	Infant_development	Child_development	Infant	Infant_massage	Asian_people
asian babies development	Child_development	Infant	Babies	Asian_people	Asian_Development_Bank
developmental milestones asia	Developmental_milestones	Milestones	Asia	Child_development_stages
are developmental milestones universal	Developmental_psychology	Universal_Studios	Milestones	Developmental_milestones	Child_development_stages
asian developmental milestones	Developmental_milestones	Milestones	Race_and_ethnicity_in_the_United_States_Census	Child_development_stages
chinese infant developmental milestones	Infant_development	Infant	Developmental_milestones	Chinese_culture	Child_development_stages
chinese infant milestones	Wikipedia:Milestones	Developmental_milestones	Chinese_culture	Infant_mortality	Child_development_stages
infant milestones variations	Infant	Infant_bed	Child_development_stages	Infant_formula
infant milestones cultural	Culture	Infant	Infant_mortality	Child_development	Developmental_milestones	Child_development_stages
infant milestones differences	Infant_development	Infant	Infant_mortality	Sexual_dimorphism	Child_development_stages	Neonate
asian children milestones	Developmental_milestones	Angelina_Jolie	Child_development_stages	Milestones_Museum	Child	Asian_people
ky powerball	Powerball	Kentucky_Lottery	Low-carbohydrate_diet	Kentucky
facebook	History_of_Facebook	Facebook
Charles Basil biography	Charles_I_of_Naples	Talk:Charles_Basil_Price	Basil_of_Caesarea	Charles_Basil_Price	Biography	Charlie_Chaplin
Charles Basil acomplishments	Basil_of_Caesarea	Basil_II	Charles_I_of_Naples	Basil_Charles_Godfrey_Place	Charlemagne
Basil  Charles	Basil_of_Caesarea	Charles_Basil_Price	Charles_I_of_Naples	Basil_Charles_Godfrey_Place
"pest control" how to	Pest_(organism)	Biological_pest_control	How-to	Pest_control
"pest control" courses	Pest_(organism)	Orkin	Golf_course	Diatomaceous_earth	Pest_control
"pest control" manual "how-to"	Pest_(organism)	User_guide	How-to	Biological_pest_control	Pest_control	Sex_manual
madagascar penguin pics	Platform_for_Internet_Content_Selection	Madagascar_(2005_film)	Penguins_of_Madagascar	The_Penguins_of_Madagascar	Penguin
animated penguin pics	Platform_for_Internet_Content_Selection	The_Penguin	Animation	Penguin
southwest rapid rewards login	Southwest_Airlines	Main_Page	Login	Southwest_airlines
eurozone crisis responses	Eurozone_crisis	Eurozone	Causes_of_the_Eurozone_crisis	European_sovereign-debt_crisis	Response_(liturgy)
eurozone crisis leader actions	Eurozone_crisis	Eurozone	Labour_Party_(UK)	European_sovereign-debt_crisis
dinosaurs pics	List_of_dinosaurs	Dinosaur	Dinosauria	Platform_for_Internet_Content_Selection
dinosaurs	Dinosaur	Dinosaurs_(TV_series)
Kursk   Barents see   Russian politics	Demographics_of_Russia	Barents_Sea	Politics_of_Russia	Kursk	Russians	Holy_See	Russia
Kursk   Barents see   Russian politics   causes	Demographics_of_Russia	Barents_Sea	Politics_of_Russia	Russian_submarine_K-141_Kursk	Kursk	Russians	Holy_See	Paralysis	Russia	Kursk_submarine_disaster
Kursk   Barents sea   causes	Barents_Sea	Russian_submarine_K-141_Kursk	Russian_submarine_Kursk_explosion	Causes_(company)
facebook.com	History_of_Facebook	Facebook
nurse gets 10 years	Nursing	Registered_nurse	Anniversary
the company	The_Company_(film)	Company	The_Company_(TV_miniseries)	East_India_Company
the company new york stock exchange	Stock_exchange	Companies_listed_on_the_New_York_Stock_Exchange_(A)	New_York_Stock_Exchange	Corporation	The_New_York_Stock_Exchange
earthquake data	1968_Illinois_earthquake	Earthquake	Earthquakes_in_2013	Data_(Star_Trek)
earthquake incidence worldwide	2010_Haiti_earthquake	World	Angle_of_incidence	Earthquakes_in_2011	Incidence_(epidemiology)
earthquake mapping	Cartography	Earthquake_map	Geoscience_Australia	Seismicity	1968_Illinois_earthquake	Earthquake
disneyland hotel	Disneyland_Hotel	Disneyland_Hotel_(California)	Disneyland_Hotel_(Hong_Kong)
disneyland hotel reviews	Disneyland_Hotel	Disneyland_Hotel_(California)	Review	Disneyland
diversity	Diversity_(dance_troupe)	Multiculturalism	Diversity
promoting diversity	Promoter_(entertainment)	Cultural_diversity	Multiculturalism	Diversity_(politics)
bridal shower favors	Bridal_shower	Party_favor	Malachi_Favors
party city	Party_City	Party	Mexico_city
bath and body works	Bath_&_Body_Works	Bath_&_Body_Works	Bath
wedding shower sayings	Bridal_shower	Saying	Wedding
bridal shower party favors	Bridal_shower	Party_favor
yellowpages	Yellow_Pages_Singapore	Yellow_Pages
facebook	History_of_Facebook	Facebook
methods and programs for quitting smoking	Cold_turkey	Methodology	Computer_program	Smoking_cessation
breakdown	Breakdown	Breakdown_(film)	Breakdown_(1997_film)	Break_(music)
demo	DEMO	Demo_(music)	Demos
demo reel	Demo_reel	Reel
yahoo! deals	Yahoo!
demo reel music	Reel	Demo_(music)	Reel_Music
quicktime pro	Adobe_Premiere_Pro	QuickTime
Merck lobbists	Max_Baucus	Gardasil	Merck_&_Co.
Merck lobbying US policy	Lobbying_in_the_United_States	Policy	Merck_&_Co.	Lobbying	The_Israel_Lobby_and_U.S._Foreign_Policy	United_States_dollar
tornadoes	Tornado	Panavia_Tornado
forecasting tornadoes	Tornado	Tornadoes_in_the_United_States	Tornadogenesis	Weather_forecasting
star trek	Star_Trek	Star_Trek:_The_Original_Series	Star_Trek_(film)
star trek voyager	Star_Trek	Star_Trek:_Voyager
martin aircraft	Glenn_L._Martin_Company	Category:Martin_aircraft	Aircraft
b57	Martin_B-57_Canberra	B57_nuclear_bomb	B57	Volvo_BB57
"event planning" studying college	Study_skills	Event_planning	College_(The_Sopranos)
"event planning" college	Event_planning	Planning	College_(The_Sopranos)
louisville courier journal	The_Courier-Journal	Louisville_Courier-Journal	Louisville,_Kentucky
ncaa football scores	College_football	NCAA_Football_series	NCAA_Football_10	20_(number)	American_football	National_Collegiate_Athletic_Association
syracuse.com	The_Post-Standard	Syracuse,_New_York	Syracuse
rochester democrat and chronicle	Democrat_and_Chronicle	Rochester,_New_York
onondaga community college	Community_college	Onondaga_Community_College
american hockey league	List_of_ice_hockey_leagues	North_American_Hockey_League	American_Hockey_League
albany times union	Times_Union_Center	Times_Union_(Albany)
minneapolis star tribune	Minneapolis_Star_Tribune_Company_v._Commissioner	Star_Tribune
southeast conference	Southeastern_Conference	Southeast_Asia_Treaty_Organization	Southeast_Conference_(Iowa)
atlantic coast conference	Category:Atlantic_Coast_Conference	Atlantic_Coast_Conference
big east	Big_East_Conference	Big_East_Conference_(1979–2013)
legality gun control	Spud_gun_legality	Gun_control	Gun_politics	Gun_prohibition	Law
history crossword	Crossword	Crossword_Puzzle	History
history word searches	Word_search	History_of_modernisation_theory	World_History	History
New York City	New_york	New_York_City	New_York_City,_New_York
Chicago	Chicago_(band)	Chicago
Washington DC	Washington	Washington,_DC	Washington,_D.C.	Washington_dc
legal advice	Legal_guardian	Legal_advice	Legal_aid
renters protection law	Renting	Consumer_protection	Law	Smoker_protection_law
most violent gun violence events	Gun_violence	Gun_violence_in_the_United_States	Violent_crime	Violence	May_1968_protests_in_France
gun violence us campuses	Gun_violence	List_of_school_shootings_in_the_United_States	Campus	Gun_violence_in_the_United_States
most deadly type of gun in gun violence	Gun_violence_in_the_world	Gun_violence	The_Deadly_Awards	Gun_violence_in_the_United_States	Gun_politics	Gun_politics_in_Australia	Type_(biology)
mail	Mail	Email
eithad	Etihad	Etihad_Airways
payless shoes	Payless_ShoeSource	File:Payless_ShoeSource_Logo.svg
coldwell banker	Coldwell_Banker	Coldwell_Banker_Residential_Real_Estate	Coldwell_Banker_New_Homes
centruy21realastate	Century_21_Real_Estate	Century_21
merril shoes	Merrill's_Marauders	Merrell_(company)	Bob_Merrill	Judith_Merril	Shoe
vibram shoes	Vibram_FiveFingers	Vibram	Wrestling_shoe
ryka shoes	Brown_Shoe	Category:Shoe_brands	Rykä
nike	Nike,_Inc.	Nike_(mythology)	Nike
ebay	Criticism_of_eBay	EBay
big lots	Big_Lots	Land_lot
toys r us	Toys_"R"_Us	Toy	Toys_"R"_Us	Toy_Story
mlive	Booth_Newspapers	Flint,_Michigan	Kalamazoo,_Michigan
occitaine	L'Occitane_en_Provence	L
urinary tract infection treatment	Urinary_tract_infection	Pharmacotherapy	Urinary_system
gps devices	Electronics	GPS_navigation_device	Global_Positioning_System
garmin	Garmin_.img	Garmin_nuvi	Garmin
msft	Microsoft	MSFT
aa	AA	The_Automobile_Association	Alcoholics_Anonymous
er download watch online	Uploading_and_downloading	Watch_(TV_channel)	Internet	Emergency_department	Watch	ER_(TV_series)
er episodes	Joey_(TV_series)	List_of_ER_episodes	ER_(TV_series)
candy tree centerpiece	Centerpiece	Centrepiece	Tree	Candy
yahoo! calendar	Yahoo!_Calendar	Yahoo!
yahoo! games	Yahoo!_Games	Yahoo!
google	Google_Earth	Google
gooo	Go-oo	Gooo	Good
google homepage	IGoogle	Google_Search	Google+	Google
happy kitchen hamburger	Happy_(The_Rolling_Stones_song)	Happy_Michelin_Kitchen	Hamburger	Kitchen
savemart	Save_Mart_Supermarkets	Save_Mart_Center_at_Fresno_State
burlington wisconsin	Burlington_(town),_Wisconsin	Burlington,_Wisconsin
Burlington Wisconsin	Burlington_(town),_Wisconsin	Burlington,_Wisconsin
Traditional Swahili meals	Tea_(meal)	Swahili_language	Tradition	Meal
Kenyan recipe	Kenya	Agriculture_in_Kenya	Recipe
twinkies may survive	Survive_(David_Bowie_song)	Twinkie	Da_Boom	Brian_May
gun control	Gun_politics_in_the_United_States	Gun_control
gun control laws	Gun_politics_in_the_United_States	Gun_politics_in_Canada	Gun_control	Legislation	Gun_laws_in_California
gun control outcomes	Gun_control	Gun_control_in_the_United_States
ban guns	Gun_ban	Federal_Assault_Weapons_Ban	Firearm	Gun_(band)
"Nicknames" what are	Nickname	List_of_U.S._state_nicknames
derivation of "nickname"	Derivation_(linguistics)	Nickname	Origin_of_the_name_"Windy_City"
thesaurus "nickname"	Nosey_Parker	Tory	Nickname	Thesaurus
road trip	On_the_road	Road_Trip_(film)	Road_trip	Road_Trip
best road trips	The_Best_(song)	Road_trip	Road_Trip
best worst road trips	Hooters_Road_Trip	The_Best_(song)	Road_trip	Road_Trip	The_Worst_(Tech_N9ne_album)
romantic road trips	College_Road_Trip	Road_trip	Road_Trip	Romantic_Road
enjoyable boring road trip	Boring,_Oregon	Road_trip	Road_Trip_(Parks_and_Recreation)	Road_Trip
enjoyable boring getaways	List_of_hobbies	Boring,_Oregon	Tosh.0	Pegging_(sexual_practice)
best getaways	The_Getaway_Plan	The_Best_(song)	Giada's_Weekend_Getaways
giant eagle	Giant_Eagle	Giant_eagle_(Dungeons_&_Dragons)
phone plan	Mobile_phone	Telephone	Floor_plan	North_American_Numbering_Plan
"cell phone plan"	Cellphone_overage_charges	Mobile_phone	Floor_plan	Prepaid_mobile_phone
"cell phone plan :.uk"	Mobile_phone	Plan_UK
us space exploration costs	Vision_for_Space_Exploration	Cost	Space_exploration	United_States_dollar
bdubs menu	Talk:Buffalo_Wild_Wings	Buffalo_Wild_Wings	Bdubs	Menu
how soon can you feel pregnancy symptoms	Pregnancy	Feeling	Music_Canada	With_You_(Jessica_Simpson_song)
getting pregnant while on mirena	Pregnancy	Getting_By	IUD_with_progestogen
modern payments website	Modern_Records	Website	Tate_Modern	Payment	Modern_dance
amazon	Amazons	Amazon	Amazon.com
charlie sheen lohan	Charlie_Sheen	Lindsay_Lohan	Scary_Movie_5
taylor lautner regret	Taylor_Lautner	Regret_(horse)
tron actress	Tron_(soundtrack)	The_Misadventures_of_Tron_Bonne	Tron:_Legacy	Actor	Olivia_Wilde
olivia wilde	Olivia_Wilde
heat vs pacers 2013 game 6	2013_NBA_Playoffs	Miami_Heat	V_speeds	Indiana_Pacers	2008_NBA_Finals
hydrocodone chlorphen er suspension	Emergency_department	Suspension_(chemistry)	Hydrocodone	Oxycodone
amox tr-k clv	Amoxicillin	TrkA_receptor	Constant_linear_velocity	Amox/k_clav
pat riley	Pat_Riley	Pat_Riley_Basketball
xanax	Alprazolam	Wikipedia	Xanax
buy lunesta	Eszopiclone	Buy,_Kostroma_Oblast	Zopiclone	Lanista
kiwi fruit	Kiwifruit	Kiwi_(people)	Kiwi_fruit
grow kiwi tree	Actinidia_arguta	Kiwifruit	Tree	Cell_growth
surf rincon puerto rico	Puerto_Rico	Surfing	Rincón,_Puerto_Rico
hotels rincon puerto rico	Puerto_Rico	Hotel	Rincón,_Puerto_Rico
cebu pacific airlines	Cebu_Pacific_destinations	Jetstar_Pacific_Airlines	Cebu_Pacific
cebu pacific airlines promo fare	Fare	Promotional_recording	Jetstar_Pacific_Airlines	Cebu_Pacific
teachers evaluation	Evaluation	Teacher
teachers evaluation by students	List_of_music_students_by_teacher	Evaluation	Teacher	Student
teachers evaluation students peers	Peer_group	Student	Evaluation	Teacher	Peer_assessment	Course_evaluation
teachers evaluation peers	Peer_review	Peer_group	Education	Evaluation	Teacher
teachers evaluation peers students	Peer_group	Student	Evaluation	Teacher	Peer_assessment	Course_evaluation
teachers evaluation wikipedia	Teacher_evaluation	Evaluation_(disambiguation)	Psychological_evaluation	Evaluation	Wikipedia	Education	Value-added_modeling	Teacher
teachers assement	Formative_assessment	Education	Educational_assessment	Teacher_quality_assessment
teachers excellence	Ron_Clark_(teacher)	Excellence	Teacher
teache assement wikipedia	Assessment_for_Learning	Educational_assessment	Psychological_evaluation	Assessment	Formative_assessment	Wikipedia	Teacher_quality_assessment
internet speed test	Speedtest.net	Thoroughly_Modern_Millie_(musical)	Internet_access	Browser_speed_test	Internet
www.nakedjuice.com	Component_Object_Model	Naked_Juice	PepsiCo	World_Wide_Web
you	Wysiwyg	With_You_(Chris_Brown_song)	You_Da_One	You
taylor lautner regret	Taylor_Lautner	Regret_(horse)
dial-a-smoke crackdown	Crackdown
danica patrick divorce	Divorce	Danica_McKellar	Danica_Patrick
Danica Patrick divorce	Divorce	Danica_McKellar	Danica_Patrick
oksana baiul	Oksana	Oksana_Baiul
girl fatally shot on school bus	Girl	Shooting	School_bus
Pseudoscyesis causes review	Causes_of_autism	Review	Cellulite	Vulvodynia
Pseudoscyesis causes	Causes_(company)
Pseudoscyesis	
best online shopping sites	Shopping	Best_Products	Online_shopping
liz claiborne outlet	Liz_Claiborne	Outlet_store	Liz_Claiborne,_Inc.
kohl's	Kohl's
bed bath and beyond	Talk:Bed_Bath_&_Beyond	Special:MobileLanguages/Bed_Bath_&_Beyond	Bed_Bath_&_Beyond	Bed_Bath_&_Beyond
sears	Sears	Sears_Canada
snopes	Snopes	Snopes.com	Barn_Burning	Snopes_trilogy
walmart	Walmart	Criticism_of_Wal-Mart
chase bank	Chase_Bank	Chase_(bank)	JPMorgan_Chase
second reformed church	Dutch_Reformed_Church	Second_Temple	Reformed_Church_in_America
frequency hematology report	Radio_frequency	Explosion	Hematology	Haematologica
frequency hematology report body chemistry	Clinical_chemistry	Explosion	Human_body	Radio_frequency	Chemistry	Hematology
obama family tree	Michelle_Obama	Family_tree	Family_of_Barack_Obama
obama family	Michelle_Obama	Family_of_Barack_Obama	Obama
google interpreter english to spanish	Spanish_language	Language_interpretation	English_language	Google_Search	Interpreter	Spanish_to_english
google translation english to spanish	English_language	Google_Translate	Google+	Spanish_language	Translation
hiv aids prevention cure charities in africa	Prevention_of_HIV/AIDS	HIV	Africa	HIV/AIDS_in_Africa	Cure	HIV/AIDS	Charitable_organization	AIDS
bon jovi's daughter arrested	Arrest	Daughter_(song)	Bon_Jovi
hunting trips in arizona	Dick_Cheney_hunting_incident	Arizona	Tourism	Hunting
hunting regulations in arizona	Waterfowl_hunting	Arizona	Code_of_Federal_Regulations	Hunting
liquids in carry-on	Carry_On_Screaming!	Liquid_Snake	Liquid
air travel information	Travel	Airliner	Information_technology	Air_travel
"space sounds like" astronauts	Sound	Astronaut	Outer_space
"space sound like" astronauts	Sound	Astronaut	Space
Jay-Z production company	Production_company	Jay-Z
Jay-Z marry	Same-sex_marriage	Jay-Z	Lisa_Marie_Presley
Jay-Z albums	Jay-Z_discography	The_Black_Album_(Jay-Z_album)	Jay-Z	Billboard_charts
igo 8	IGO_(software)	ICarly:_iGo_to_Japan	I-GO
igo 8 maps	IGO_(software)	Maps_(song)	Go_(game)	Google_Maps
pita jungle newport	Pita	The_Jungle_(Wheldon_Road)	Hammock	Newport	Main_Page
forearm pain exercises	List_of_weight_training_exercises	Pain	Physical_exercise	Forearm
forearm braces	Tennis_elbow	Bracer	Orthotics	Leg_braces	Forearm
arizona game and fish department	Fish_and_Game	Arizona_Game_and_Fish_Department
arizona regulations hunting fishing	Arizona	Recreational_fishing	Fishing	Hunting	Code_of_Federal_Regulations
spanish to english translation	Spanish_language	Translation	Indian_English	English_language
iron in food	Food	Iron_deficiency_(medicine)	Iron
iron supplements	Iron_supplements	Iron	Iron_supplement
officer shot 12 times	Officer_(armed_forces)	The_Times	NWA_Pacific_Northwest_Tag_Team_Championship	Ballistic_trauma	Microsoft_Office	The_Office_(U.S._TV_series)
ed begley jr	Ed_Begley	Ed_Begley,_Jr.
yossi dina	Yossi_Banai	The_Office	Yossi_Dina	Dirección_de_Inteligencia_Nacional
deborah raffin dies	Deborah_Raffin	Die_(manufacturing)	Raffin
Deborah Raffin dies	Deborah_Raffin	Die_(manufacturing)	Raffin
david petraeus rehire	David_Petraeus
life of pi	Life_of_Pi_(film)	Life_of_Pi
hector camacho	Camacho	Héctor_Camacho	Hector_Camacho	Héctor_Camacho,_Jr.	Hector_Camacho_Jr
pinterest	Pinterest
missing girl dragged by hair	Drag_and_drop	Missing_(Everything_but_the_Girl_song)	Missing_white_woman_syndrome	Hair_(musical)	Girl	Look_What_the_Cat_Dragged_In
yellow pages	Yellow_Pages	Yellow
target	Target_Corporation	Target_Field
hamilton beach coffeemaker	Hamilton_Beach	Hamilton_Beach,_Queens	Hamilton_Beach_Company	Coffeemaker
craigslist	Craigslist	Craigslist_Joe
vermontville	Kombucha	Vermontville,_Michigan	Vermontville,_New_York
the vermont country store	County	Vermont	Vermont_Country_Store
42 years in a coma	Coma	Elaine_Esposito
jp morgan chase data centers	J._P._Morgan	Data_center	JPMorgan_Chase
how to measure a door	Blower_door	Door	Measure	How-to	Measurement
facebook	History_of_Facebook	Facebook
climax mine	Climax,_Colorado	Climax_mine	Climax,_Pennsylvania
climax mine leadville	Climax,_Colorado	Climax_mine	Leadville,_Colorado
google earth	Google_Earth	Google_(verb)	Google_Maps	Earth
google	Google_Earth	Google
bob berg	Bob_Berg	Bob_Bergen
cunard cruise lines	Cunard_Line	Cruising_(maritime)	White_Star_Line	Cruise_line
carnival uk	Carnival_Corporation_&_plc	Carnival_UK	Carnival
cunard cruise lines director	Cunard_Line	Chief_executive_officer	Cruise_ship	Cruise_line	Cruising_(maritime)
cunard cruise lines managing director	Cunard_Line	Chief_executive_officer	Carnival_Corporation_&_plc	Cruise_line	Cruising_(maritime)
webmail	Webmail	E-mail	E-mail_spam
ebay.com	Criticism_of_eBay	EBay
ups.com	Communist_Party_USA	Grown_Ups_(film)	UPS	Uninterruptible_power_supply
lefeld implement coldwater ohio	Implementation	Manure_spreader	Jerzy_Lefeld	Coldwater,_Ohio	Coldwater_High_School_(Coldwater,_Ohio)
dehumidifiers	Dehumidifier	Humidifier
dehumidifiers timer frost-free	Kenmore_(Brand)	Dehumidifier	Frost	Timer	Auto-defrost
balance starbucks gift card	Stereophonic_sound	Gift_card	Starbucks
starbucks gift card	Starbucks	Gift_card
"march madness"	March_Madness	NCAA_Men's_Division_I_Basketball_Championship
"march madness" NCAA	NCAA_March_Madness_(CBS/Turner)	March_Madness	NCAA_Men's_Division_I_Basketball_Championship	National_Collegiate_Athletic_Association
"march madness"	March_Madness	NCAA_Men's_Division_I_Basketball_Championship
NCAA	Ncaa	NCAA_Men's_Division_I_Basketball_Championship	National_Collegiate_Athletic_Association
NCAA tournament	2009_NCAA_Men's_Division_I_Basketball_Tournament	2014_NCAA_Men's_Division_I_Basketball_Tournament	NCAA_Men's_Division_I_Basketball_Championship
NCAA tournament "march madness"	NCAA_March_Madness_(CBS/Turner)	NCAA_Men's_Division_I_Basketball_Championship
NCAA tournament "march madness" wikipedia	2009_NCAA_Men's_Division_I_Basketball_Tournament	March_Madness	Wikipedia	NCAA_Men's_Division_I_Basketball_Championship
NCAA tournament "march madness" 2012 championship runner-up	2012_NCAA_Men's_Division_I_Basketball_Tournament	NCAA_Men's_Division_I_Basketball_Championship	Runner-up	All-Ireland_Senior_Hurling_Championship_2012	2012_March_Madness
won NCAA "march madness" 2012	2012_NCAA_Men's_Division_I_Basketball_Tournament	NCAA_Men's_Division_I_Basketball_Championship	Football_at_the_1996_Summer_Olympics	National_Collegiate_Athletic_Association
NCAA "march madness" 2012 results	NCAA_March_Madness_(CBS/Turner)	2012_NCAA_Men's_Division_I_Basketball_Tournament	NCAA_Men's_Division_I_Basketball_Championship	National_Collegiate_Athletic_Association
NCAA "march madness" 2012 broadcast	Broadcasting_of_sports_events	2012_NCAA_Men's_Division_I_Basketball_Tournament	NCAA_Men's_Division_I_Basketball_Championship	NCAA_March_Madness_(CBS/Turner)	2012_March_Madness	National_Collegiate_Athletic_Association
NCAA "march madness" 2012 semifinals sport news	2012_March_Madness	Single-elimination_tournament	National_Collegiate_Athletic_Association	Sports_journalism	2012_NCAA_Men's_Division_I_Basketball_Tournament	NCAA_Men's_Division_I_Basketball_Championship
man sues ugly baby	Infant	Human	Beauty	Lawsuit	Invisible_Woman	Mary_Sue
Philadelphia tourist attractions	Tourist_attraction	Tourism	Philadelphia
hawaii real estate family resale OR foreclosure	Family	Reseller	Foreclosure	Real_estate	Hawaii
hawaii real estate family resale OR foreclosure news	Foreclosure	Family	Real_estate	News	Sales	Hawaii
hawaii real estate family resale value house OR condo news	Family	Value_(economics)	House	Hawaii	Sales	Condominium	Real_estate	News
hawaii real estate average resale value house OR condo news	Weighted_mean	Value_(economics)	House	Sales	Hawaii	Condominium	Real_estate	News
quit quitting smoking	Cold_turkey	Smoking_cessation
hot tug	Tugboat	Sour_Candy_(Carly_Rae_Jepsen_song)	Temperature	Tug_(film)
now you see me	You_Da_One	How_Will_I_Know	Now_You_See_Me_(film)
world war z movie	World_War_Z_(film)	World_War_Z	Z_movie	World_war_z
now you see me rotten tomatoes	Tomato	Rotten_Tomatoes	How_Do_You_Know	Now_You_See_Me_(film)
world war z movie review	Film_criticism	World_War_II	World_War_Z	Z_movie	World_war_z
reduce airconditioning	Solar_air_conditioning	Air_conditioning	Redox
attic insulation airconditioning costs	Attic	Air_conditioning	Attic_Insulation	Costs_(English_law)	Building_insulation
long-term care insurance	Long-term_care	Long-term_care_insurance
long term care insurance	Insurance	Long-term_care_insurance	Health_insurance
long term care insurance uk	United_Kingdom	Long-term_care_insurance	Health_insurance
long term care insurance uk u00a3	United_Kingdom	Insurance	Long-term_care_insurance	Health_insurance
long term care insurance "united kingdom" OR britain OR england	United_Kingdom	England	Insurance_in_the_United_Kingdom	Long-term_care_insurance
long term care insurance -usa	Long_term_care_insurance	Long-term_care	United_States	Long-term_care_insurance
dick clark	Dick_Clark's_New_Year's_Rockin'_Eve	Dick_Clark
advice for technology start-up	Startup_company	East_London_Tech_City	Financial_adviser
$425 million jackpot	Lottery_jackpot_records	Million	Prize	Mega_Millions
ocd beckham	Obsessive–compulsive_disorder	David_Beckham	Ocd
ocd famous sufferers	Obsessive–compulsive_disorder	Suffering	Obsessive-compulsive_disorder	Ocd	Acute_intermittent_porphyria
(euro OR eurozone) crisis	2007–2012_global_financial_crisis	Eurozone	Eurozone_crisis	European_sovereign-debt_crisis
sasha and malia	Malia,_Crete	Family_of_Barack_Obama	Sasha_(name)
darrell royal dies	Darrell_Royal	Die_(manufacturing)	Darrell
diane sawyer slurring	Diane_Sawyer	Relaxed_pronunciation	Sawyer
Diane Sawyer slurring	Diane_Sawyer	Relaxed_pronunciation	Sawyer
eva longoria in tears	Eva_Longoria	Tears	Evan_Longoria
walmart	Walmart	Criticism_of_Wal-Mart
sears	Sears	Sears_Canada
best buy	Best_Buy_Theater	Best_Buy
orbitz airline tickets expedia	Expedia	Orbitz	Airline	Airline_ticket
aarp travel discounts	AARP	Travel	Discounting
ea ncaa football 2014	College_football	NCAA_Football_series	EA_Sports	American_football	NCAA_Football_14	National_Collegiate_Athletic_Association
perfect pitch	Pitch_perfect	Absolute_pitch	Perfect_pitch
superman tv show	Superman_(TV_series)	Batman_(TV_series)	Adventures_of_Superman_(TV_series)	Superman
dean cain	Dean_Cain
atlanta zoo	Zoo_Atlanta	Zoo
mark sanchez	Mark_Sanchez	Claudio_Sanchez
mark sanchez buttfumble video	Video_game	Butt_fumble	Mark_Sanchez	Mark_Sanford
teach yourself programming	Programming_(music)	Teacher	Logo_(programming_language)	Teach_Yourself
best programming language for beginners	Programming_language	Beginners	The_Best_(song)	List_of_educational_programming_languages	BASIC
pnc	PNC_Financial_Services	PNC_Park	PNC_(rapper)
continental plates	Plate_tectonics	List_of_tectonic_plates	Continental_plate
continental drift	Continental_drift	Ice_Age:_Continental_Drift
Indian politics   Miss Universe	Politics_of_India	List_of_Miss_Universe_titleholders	Femina_Miss_India	Miss_India	Miss_Universe
politics Indian Miss Universe	List_of_Miss_Universe_titleholders	Femina_Miss_India	Political_science	Indian_people	Miss_India	Miss_Universe
politics 1994-2000  Indian Miss Universe	Montana	Main_Page	Femina_Miss_India	Political_science	Indian_people	Miss_Universe
twitter	Twitter
chanel company	Coco_Chanel	Chanel	Company_(magazine)
chanel museum exhibition clothing	Exhibition	Museum	Clothing	Chanel
chanel president	President_of_the_United_States	Chanel	Disney_Channel	President_of_France	Coco_Chanel
chanel clothes award ceremonies women	Award_ceremony	Woman	Clothing	Chanel
chanel top fragrance	Perfume	Chanel	Top_(clothing)
chanel top fragrance in the world	Top_(clothing)	Aroma_compound	World	Chanel_No._5	Chanel
windows password recovery tool 3.0	Programming_tool	Windows_7	Microsoft_Windows	Microsoft_windows	Password_cracking
Secondhand camera shop	Second-hand_shop	Retail	Used_good	Camera	Charity_shop
Travel information Los Angeles	Los_Angeles_International_Airport	Information	Travel	Los_Angeles
Local Travel information Los Angeles	Los_Angeles_International_Airport	Information	Los_Angeles,_California	Local_government	Travel	Los_Angeles
gmat prep classes	Kindergarten	Social_class	Graduate_Management_Admission_Test	ManhattanGMAT
practice gmat exams	Test_(assessment)	Graduate_Management_Admission_Test	Medical_practice	GRE
marsupials ecology behaviur	Wombat	Ecology	Behavior	Behavioral_Ecology_(journal)	Behavioral_ecology	Marsupial
marsupials cartoon	List_of_fictional_marsupials	Animation	Koala	Marsupial
tasmanian tiger	Ty_the_Tasmanian_Tiger	Tasmanian_Tigers	Thylacine
regular phones vs internet phones voip experiences cheapest	Internet	Voice_over_IP	Ship_prefix	Telephone	VoIP	Guitar_tunings
internet phones voip experiences cheapest	Voice_over_IP	Telephone	VoIP	Internet
internet phones voip reviews	VoIP_phone	Internet	Voice_over_IP	Review	Telephone	VoIP
youtube	Youtube	YouTube	List_of_YouTube_personalities
oklahoma school of science and mathematics	Philosophy_of_mathematics	School	University_of_Central_Oklahoma	Oklahoma_School_of_Science_and_Mathematics
wall hung toilet kohler	Toilet	Hanging	Wall	Toilet_paper_orientation	Kohler_Company
wall hung toilet	Wall	Toilet	Flush_toilet	Hanging
bbva compass	BBVA_Compass_Bowl	BBVA_Compass	BBVA_Compass_Stadium
www.cpsenergy.com	Pituitary_tumor	Component_Object_Model	CPS_Energy	World_Wide_Web
clearview cinema morristown	Clearview_Cinemas	Morristown,_New_Jersey	Clearview
madison theater	Madison_(TV_series)	The_Theater_at_Madison_Square_Garden	Madison_Square_Garden	Theatre
54 main madison nj	Main_Line_(NJ_Transit)	Madison	Madison_Square_Garden	Madison,_New_Jersey	Madison,_Wisconsin
msn news	MSN	MSN_TV
salerno gmc	Exercise_Mainbrace	General_Motors	Maharishi_Vedic_Approach_to_Health	Allied_invasion_of_Italy
didier drogba	Didier_Drogba	Didier
neymar	Neymar
santos soccer club	Club_Santos_Laguna	Association_football	Football_team	Santos_FC
wikipedia	Wikipedia:Manual_of_Style/Words_to_watch	Wikipedia	Wikipedia:Sound/list	Main_Page
fernando torres chelsea	Fernando_Torres	Chelsea_F.C.
fernando torres	Fernando_Torres	Fernando_Torres_(actor)
michael essien	Michael_Essien	Essie_Mae_Washington-Williams
modric	Luka_Modrić	Modric
soccer transfers	List_of_Major_League_Soccer_transfers_2014	Transfer_(association_football)	List_of_Major_League_Soccer_transfers_2015	Association_football
david beckham	David_Beckham	Beckham
jack wilshere	Jack_Wilshere	Barbara_Wilshere
theo walcott	Walcott	Theo_Walcott
tanio	Marcel_Pauker	Kirk_Morris
tainio	Teemu_Tainio	Cycling
brett michaels	Bret_Michaels	Rock_of_Love_with_Bret_Michaels
the music man songs	Pop_music	The_Music_Man	The_Music_Man_(1962_film)	The_Tigger_Movie
the music man	The_Music_Man	The_Day_the_Music_Died
fay observer	The_Fayetteville_Observer	Observer.com	Fairy	The_Charlotte_Observer	Faye_Hanohano	The_Observer
Connecticut Fire Academy training	Connecticut	National_Fire_Academy	Arkansas_Fire_Academy	Fire	Academy	Training
"Connecticut Fire Academy" training	Fire	Academy	Connecticut	Training	Fire_police
"Connecticut Fire Academy" skills	Fire	Academy	Connecticut	Skill
Australian wine Yellowtail	Yellowtail	Yellowtail_amberjack	Australian_wine	Yellow_Tail_(wine)
Australian female winemakers	Winemaker	Hungarians_in_Australia	Cornish_Australian	Female	Category:Australian_winemakers	Australians	Australian_wine
Australia female wine makers	The_Makers_(Australian_band)	Australia	Cornish_Australian	Australian_wine	Woman	Wine
Australia wine	Australia	Australian_wine	South_Australian_wine
esther phillips music	Queen_Esther_(artist)	Music	Esther_Ofarim	Esther_Phillips
facebook.com	History_of_Facebook	Facebook
free fishing lures	Fishing_tackle	Fishing_lure	Recreational_fishing	Political_freedom
free fishing lures samples	Sampling_(signal_processing)	Fly_fishing	Fishing_tackle	Fishing_lure	Recreational_fishing	Fishing	Free_(rapper)
texas fishing license age	Fishing	License	Ageing	Texas
peace corp	List_of_returned_Peace_Corps_Volunteers	Peace_Corps
peace corp apply	Peace_Corps	Peace
peace corp application	List_of_returned_Peace_Corps_Volunteers	Peace_Corps	Software
port arthur massacre	Port_Arthur_massacre	Port_Arthur_massacre_(Australia)	Port_Arthur_massacre_(China)
port arthur massacre victims	Port_Arthur_massacre	2011_Tucson_shooting	Port_Arthur_massacre_(Australia)
collagen vascular disease	Vascular_disease	Collagen	Connective_tissue_disease	Collagen_vascular_disease
impact of collagen vascular disease	Vascular_disease	Cerebrovascular_disease	Collagen_vascular_disease	Collagen	Impact_Wrestling
collagen vascular disease active lifestyle	Vascular_disease	Cardiovascular_disease	Lifestyle_(sociology)	Connective_tissue_disease	Collagen	Stroke
collagen vascular disease sport	Vascular_disease	Connective_tissue_disease	Collagen	Sport	Collagen_vascular_disease
"collagen vascular disease" sport	Vascular_disease	Sport	Ehlers–Danlos_syndrome	Methylprednisolone	Collagen	Bell_palsy
"collagen vascular disease"	Vascular_disease	Collagen	Connective_tissue_disease	Collagen_vascular_disease
quit smoking	Smoking	Smoking_cessation
quit smoking cold turkey	Cold_turkey	Turkey	Cold_Turkey_(film)	Smoking_cessation	Smoking
tumblr fashion	Tumblr	Fashion
tumblr fat	Tumblr	Obesity	Trans_fat	Polyunsaturated_fat
tumblr fat girls	Tumblr	Fat_Bottomed_Girls	Obesity	Run_the_World_(Girls)	Fat_Girl
tumblr themes	Tumblr	Reblogging	Xkcd
us coinds	Nickel_(United_States_coin)	United_States	Coin
us coins	Nickel_(United_States_coin)	Coin	Coins_of_the_United_States_dollar
us coins wiki	Wiki	Coin	United_States_dollar	Coins_of_the_United_States_dollar
coins in us wiki	Wiki	Challenge_coin	Coin	.us	Coins_of_the_United_States_dollar
cuban offers trump $1 million	Mark_Cuban	Donald_trump	Million	Donald_Trump	Cuba
history of crossword puzzle	Crossword	Crossword_Puzzle	History
crossword puzzle wiki	Wiki	Crossword	Crossword_Puzzle
churchill downs racing information	Horse_racing	Churchill_Downs_Incorporated	Churchill_Downs	Information_science
churchill downs horse racing park	Horse_racing	River_Downs_Racetrack	Churchill_Downs	Quarter-Horse_Racing	Churchill_Downs_Incorporated	Baseball_park
"churchill downs" horse racing park	Horse_racing	Quarter-Horse_Racing	Churchill_Downs	Baseball_park
"churchill downs" horse racing schedule	Horse_racing	Schedule_(computer_science)	Churchill_Downs
kentucky derby museum	Kentucky_Derby_Museum	Kentucky_Derby
churchilldowns.com	Component_Object_Model	Ack_Ack_Handicap_(Churchill_Downs)	Churchill_Downs	Churchill_Downs_Incorporated
churchilldowns	Churchill_Downs_Incorporated	Ack_Ack_Handicap_(Churchill_Downs)	Churchill_Downs
churchilldowns seating chart	Seating_assignment	Record_chart	Churchill_Downs	Chart
"churchill downs" racing seating chart	Horse_racing	Churchill_Downs	Seating_capacity	Chart
seafood receipes	Seafood	Recipe
wood to build raised garden bed	Natalie_Wood	Wood	Tiger_Woods	Raised-bed_gardening
build raised garden bed	Gardening	Garden	Raised-bed_gardening
depression symptoms	Depression_(mood)	Major_depressive_disorder	Depression
how to help depressed person	Depression_(mood)	Help!_(song)	Human	How-to	Major_depressive_disorder	Clinical_depression
rick warren obama inauguration controversy	Inauguration_of_Barack_Obama	Jeremiah_Wright_controversy	Barack_Obama_citizenship_conspiracy_theories	Rick_Warren	Barack_Obama_2009_presidential_inauguration
rick warren controversy	Jeremiah_Wright_controversy	Elizabeth_Warren	Rick_Warren
cast of starship troopers 2	Starship_Troopers_2:_Hero_of_the_Federation	Starship_Troopers	Starship_Troopers_(film)	Superman_(film)	Roughnecks:_Starship_Troopers_Chronicles
norfolk county registry of deeds	Norfolk_County,_Massachusetts	Recorder_of_deeds
linkedin	LinkedIn
windows defender reports software problems	Windows_vista	Software	Microsoft_windows	Windows_Defender
windows defender problems	Microsoft_windows	Windows_Defender
to be or not to be	Wikipedia:What_Wikipedia_is_not	Philosophy	To_be_or_not_to_be_(Shakespeare)
shakespeare quotes plays	Quotation	Play_(theatre)	Shakespeare's_plays	William_Shakespeare
used car parts	Used_car	Audi	Cars_(film)	List_of_auto_parts
junk yard	Wrecking_yard	Junkyard	Junkyard_(band)	Junkyard_Dog
mortgage survey	Mortgage_loan	Subprime_mortgage_crisis	Surveying
diabetes education	National_Diabetes_Education_Program	Education	Diabetes_mellitus	Diabetes
diabetes educator	Certified_diabetes_educator	The_Diabetes_Educator
collagen vascular diease	Collagen	Connective_tissue_disease	Blood_vessel	Collagen_vascular_disease
collagen vascular diease sport	Connective_tissue_disease	Collagen	Sport	Collagen_vascular_disease	Vascular
autoimmune disease sport	Autoimmune	Autoimmunity	Sport	List_of_autoimmune_diseases	Autoimmune_disease
autoimmune disease	Category:Autoimmune_diseases	Autoimmunity	Autoimmune_disease
continental drifting	Continental_AG	Continental_drift	Ice_Age:_Continental_Drift
plate tectonics	Plate_tectonics	Tectonics
little rascals cast	Boy_Meets_World	Our_Gang	The_Little_Rascals_(animated_TV_series)	The_Little_Rascals_(film)
comadre	Comadre_(band)	Comadre	La_Comadre	Comadre_Florzinha	Compadre
club pictures	Club_Kids	Film	Golf_club	Club_(weapon)
facebook.com	History_of_Facebook	Facebook
los angeles national forest	Los_Angeles,_California	Los_Angeles_County,_California	Angeles_National_Forest
macana	Urumi	Macana
police stick	Abner_Louima	Glow_stick	Stick_fighting	The_Police	Police_car
holding breath underwater	Breath_holding	Underwater	Apnea	Free-diving
baby cow	Baby_Cow_Productions	Cow
towers	The_Towers_(Manchester)	Tower	Tower_of_Babel	Leaning_tower_of_pisa
google	Google_Earth	Google
job search	Steve_jobs	Book_of_Job	Job_hunting
quotes about life	Life	Wikipedia:About	Life_insurance	Yogi_Berra
metro blue line schedule	Schedule_(computer_science)	Blue_Line_(Washington_Metro)	Blue_Line_(Los_Angeles_Metro)
blue line schedule	Schedule_(computer_science)	Blue_Line	Lynx_Rapid_Transit_Services	Blue_Line_(Washington_Metro)
los angeles blue line schedule	Schedule_(computer_science)	Blue_Line_(Los_Angeles_Metro)	Los_Angeles_Dodgers
facebook	History_of_Facebook	Facebook
metro	Brussels_Metro	Metro_(design_language)	Rapid_transit
happy b day cards e-card	E-cards	Birthday	Greeting_card	E-card	Happiness
gay marriage	Same-sex_marriage	Same-sex_marriage_in_the_United_States
sunset	Sunsets	Sunset
broken heart quotes	Broken_heart	No_Hurt_Like_a_Broken_Heart	Broken_Hearts	Jamie_Zawinski
mothers beach in long beach	Long_Beach,_California	The_Mothers_of_Invention	Brian_Wilson	Normandy_Landings
gmail sign in account	Google_Account	User_(computing)	At_sign	Gmail
where is dulles airport?	Airport	Washington_Dulles_International_Airport
dulles airport virginia	Dulles,_Virginia	Dulles_International_Airport	Washington_Dulles_International_Airport	Dulles_Airport,_Virginia
dulles airport virginia transport to other cities	Administrative_divisions_of_New_York	Washington_Dulles_International_Airport	List_of_airports_in_Virginia	International_Air_Transport_Association_airport_code	Transport	Dulles,_Virginia
GS pay tables	General_Schedule_(US_civil_service_pay_scale)	GS	Table_(database)	General_Schedule	Gansu
uss abraham lincoln	USS_Abraham_Lincoln_(CVN-72)	Assassination_of_Abraham_Lincoln	Abraham_Lincoln
jon gruden rumors	John_Gruden	Rumors	Jon_Gruden
hamas wiki	Wikia	History_of_Hamas	Hama	Hamas
kim kardashian	Kim_Kardashian
public nudity ban	Nudity	Ban_(title)	Public_nudity
Public nudity ban	Nudity	Ban_(title)	Public_nudity
public nudity	Nudity	Public_nudity
mimeo board	Mimeo,_Inc	Apple_I	Paperboard	M.I.M.E.O.	Macroprudential_regulation
discovery channel stores	Retail	Discovery_Channel	Discovery
science toys for kids	Science	Toys_(film)	Toys	Sid_the_Science_Kid	Child
scientific glass blowing	Glass	Scientific_revolution	Glassblowing	Scientific_glassblowing	Venetian_glass
scientific glass blowing history	Glassblowing	Venetian_glass	Science	Glass_blowing	History
glass blowing science	Science	Glassblowing	Glass_Science
merck & co. lobbying	Merck_&_Co	Gardasil	Merck_&_Co.
merck and co. lobbying	Lobbying	Merck_&_Co.	Merck_&_Co.
merck and co	Merck_Manual_of_Diagnosis_and_Therapy	Merck_&_Co.	Merck_&_Co.
merck and co policies	Policy	Gardasil	Main_Page	Merck_&_Co.
michworks	
jobs michigan	Michigan	Lansing,_Michigan	Job_(role)
patriots point museum	Patriots_Point	Museum	New_England_Patriots
uss yorktown	USS_Yorktown_(CV-10)	USS_Yorktown_(CV-5)	USS_Yorktown_(CG-48)
Boston pops  and (salary OR manager OR conductor OR hall)	Salary	Conducting	Boston_Pops_Orchestra	Management	Boston_Symphony_Orchestra	Edward_T._Hall
Boston pops	Pops	Boston_Pops_Orchestra	Boston_Pops
port arthur	Port_Arthur,_Tasmania	Port_Arthur_massacre_(Australia)	Lüshunkou_District
port arthur massacre	Port_Arthur_massacre	Port_Arthur_massacre_(Australia)	Port_Arthur_massacre_(China)
facebook	History_of_Facebook	Facebook
faqcebooklogin	Login_with_facebook	Facebook
map of israel	Israel	Mahmoud_Ahmadinejad_and_Israel	Land_of_Israel	Geography_of_Israel	Kingdom_of_Israel_(united_monarchy)
employ warrant officer	Warrant_Officer	Warrant_Officer_(United_Kingdom)	Warrant_officer
employ warrant officer military services	Officer_(armed_forces)	Warrant	Warrant_officer	Military	Warrant_Officer	British_Armed_Forces
salary of warrant officer	Salary	President_of_the_United_States	Warrant_officer
job of warrant officer	List_of_United_States_Army_careers	Warrant_officer	List_of_Dirty_Jobs_episodes	Job_(biblical_figure)
king of new york	New_york	Demographics_of_New_York_City	King_of_New_York
game of thrones	Game_of_Thrones_(TV_series)	Game_of_Thrones_(season_4)	Game_of_thrones
game of thrones season 3	Game_of_Thrones_(TV_series)	Game_of_Thrones_(season_3)	Game_of_thrones	Fringe_(season_3)
ironman coeur d alene	Coeur_d'Alene,_Idaho	Ironman_Triathlon	Coeur_d'Alene_people
gregg allman	Gregg_Allman_Band	Gregg_Allman
lake hope state park	Redwood_National_and_State_Parks	Lake_District	Crater_Lake_National_Park	Crater_lake	Lake_Hope_State_Park
flipping out	Flipping_Out	Flipping	Flipping_Out_(film)
flipping out season 7	Flipping_Out	American_Idol_(season_7)	Dancing_with_the_Stars_(U.S._season_7)	Flipping	Coin_flipping
moonshiners tv show	Peep_Show_(TV_series)	Television_program	Moonshiners_(TV_series)	The_Moonshiners
moonshiners tv show season 3	Stargate_SG-1_(season_3)	Television_program	Moonshiners_(TV_series)	The_Moonshiners	Peep_Show_(TV_series)
word 2007 to 2003 converter	Office_Open_XML	Microsoft_Word	Microsoft_Office_2007
nokia lumia 920	Nokia_Lumia_920	Nokia	Nokia_Lumia	Nokia_Lumia_820
nordstrom	Nordstrom	John_W._Nordstrom
poultry farming in africa	Africa	Poultry_farming	Poultry_farming_in_the_United_States
savile sex scandal	Douglas_Barton_Osborne_Savile	Sex_scandal	Jimmy_Savile_sexual_abuse_scandal	Jimmy_Savile
evan rachel wood	Rachel_McAdams	Rachel_Wood	Tiger_Woods	Evan_Rachel_Wood
pascual perez killed	Pascual_Pérez_(boxing)	Death_of_Osama_bin_Laden	Pascual_Pérez_(baseball)
bronco bama girl	Bronco	University_of_Alabama	Girl_Scouts_of_the_USA
heidi klum	Klum	Heidi_Klum
www.facebook.com	Facebook_features	Facebook	World_Wide_Web
facebook sign up	History_of_Facebook	Facebook.com	Facebook	Up_(2009_film)	Sign
the big bang theory	List_of_The_Big_Bang_Theory_episodes	The_Big_Bang_Theory	Big_Bang
ditka suffers stroke	Stroke	Mike_Ditka
country curtains	Country_Curtains	Curtains_(1983_film)
jc penney curtains	Curtains_(musical)	J._C._Penney	J._C._Penney_Historic_District
walmart.com	Walmart	Criticism_of_Wal-Mart
canvas drop curtains	Curtain	Canvas	Olio_drop	Drop-stitch_knitting
facebook	History_of_Facebook	Facebook
backdoor	Backdoor	Backdoor_(computing)
backdoor games	Video_game	Backdoor_pilot	Basketball_moves	Backdoor_(computing)
google search	Google_Search	Google	Google_search
msn	MSN
facebook	History_of_Facebook	Facebook
3riversfcu credit union	Credit_union	Service_Credit_Union
wiki kansas city tourism	Kansas_City,_Missouri	Wikia	Kansas	Tourism
kansas city hotels airport	Kansas_City,_Missouri	Airport	Kansas	Kansas_City	Hotel	Kansas_City_International_Airport
kansas city chiefs fixtures	History_of_the_Kansas_City_Chiefs	Fixture_(property_law)	Kansas_City_Chiefs
Guinness brewery established	Guinness	Arthur_Guinness	Guinness_Brewery
Guinness brewmaster 2006	Guinness_Foreign_Extra_Stout	Guinness_(beer)	Guinness	Guinness_Brewmasters	Brewing	Brewmaster
"Guinness brewmaster"  2006	Guinness	Brewmaster
Guinness sales per day Ireland	Kingdom_of_Ireland	Guinness_World_Records	Guinness_Brewery	Guinness	New_Year's_Day	Music_recording_sales_certification
Guinness sale of pints per day Ireland	Sale_Sharks	Kingdom_of_Ireland	Guinness_Book_of_World_Records	Guinness	New_Year's_Day	Pint
percent of alcohol by volume in Guinness	Alcohol_laws_of_Utah	Alcohol_by_volume	Guinness	Long-term_effects_of_alcohol	Percentage
stout breweries  uk	United_Kingdom	Samuel_Smith_Brewery	Brewery	Stout
makita	Makita	Chainsaw
banco santander brasil	Santander_Brasil	Banco_Santander_Brasil	Santander_Group	Banco_do_Brasil
bmw x5	BMW_E70	BMW_X5
dodog	Ivan_Dodig	Dogo_Argentino
bodog	Bódog_Török	Bodog_Beck	Bodog
facebook	History_of_Facebook	Facebook
servering spinal cord paralysis	Spinal_cord	Paralysis	Spinal_Cord
servering spinal cord consequenses	Spinal_cord	Spinal_disc_herniation	Spinal_Cord
evergreen solar	Evergreen_Solar	Evergreen_Cooperatives
solar panels	Solar_panel	Solar_cell
facebook	History_of_Facebook	Facebook
samsung mobile phones	Samsung_Telecommunications	Samsung_Electronics	Mobile_phone	Samsung
amazon black friday 2012	Black_Friday_(Faderhead_album)	Black_Friday_(shopping)	Amazon.com
seven robbers shot dead	Bank_robbery	Death	Seven_Robbers	Death_of_Marvin_Gaye	Ballistic_trauma	North_Hollywood_shootout
hotmail log in email	Yahoo!_Mail	Login	Hotmail	Email
$425 million jackpot	Lottery_jackpot_records	Million	Prize	Mega_Millions
vicious dog bites trumpeter	Pit_Bull	Vicious_(rapper)	Dog_attack	Bite	Trumpet	Dog
Vicious dog bites trumpeter	Pit_Bull	Vicious_(rapper)	Dog_attack	Bite	Trumpet	Dog
bjork surgery	Bjork–Shiley_valve	Sara_Björk_Gunnarsdóttir	Bjork	Surgery	Björk	Bjork–Shiley
connecticut fire academy	Wildfire	Connecticut	National_Fire_Academy	Arkansas_Fire_Academy	Academy	Manchester,_Connecticut
connecticut fire academy established	Wildfire	Connecticut	National_Fire_Academy	Academy	New_London,_Connecticut
"connecticut fire academy"	Wildfire	Academy	Connecticut	Fire_police
google,com	Google_Earth	Google_Search	Google
Boston pops official website	Website	Boston	Boston_Pops_Orchestra	Official
hughes internet	DirecTV	Kevin_Hughes_(Internet_pioneer)	HughesNet	John_Hughes_(filmmaker)	Internet
satellite internet providers	Internet_service_provider	Internet_Service_Provider	Satellite_Internet_access
the way international	International_security	The_Way_International	Milky_Way
diabetes education videos books	Diabetes	Book	Videotape	Education	Diabetes_mellitus	American_Diabetes_Association
diabetes education	National_Diabetes_Education_Program	Education	Diabetes_mellitus	Diabetes
raised garden pics	Raised_bed_gardening	Platform_for_Internet_Content_Selection	Garden
building raised garden bed	Building	Raised_bed_gardening	Garden	Raised-bed_gardening
red bull drink health concerns	Sprouting	Red_Bull	Health	Alcoholic_beverage	Energy_drink	Vodka_Red_Bull
red bull drink side effects ban	Adverse_effect	Red_Bull	British_Approved_Name	Alcoholic_beverage	Energy_drink	Vodka_Red_Bull
red bull ban	Red_Bull_GmbH	Ban_(title)	Red_Bull	Red_Bull_Racing
dehumidifiers	Dehumidifier	Humidifier
dehumidifiers things to condiser	Dehumidifier	Thing_(assembly)	All_Things_Considered
dehumidifiers things to consider	Dehumidifier	Thing_(assembly)	All_Things_Considered
dehumidifiers technical specifications	Dehumidifier	Specification	Specification_(technical_standard)
dehumidifiers technical specifications uk	Dehumidifier	Specification_(technical_standard)	United_Kingdom
noaa	NOAA-19	National_Oceanic_and_Atmospheric_Administration	NOAA
NOAA	NOAA-19	National_Oceanic_and_Atmospheric_Administration	NOAA
bing	Bing
mapquest	MapQuest	Manure
mapquest directions driving directions	MapQuest	Driving_(horse)	Directions_(PC_Quest_album)
yahoo mapquest directions driving directions	Force	Directions_(PC_Quest_album)	MapQuest	Racing_video_game	Yahoo!_Maps	Yahoo!
yahoo mapquest directions driving directions classic	Classic_Environment	Directions_(PC_Quest_album)	MapQuest	Yahoo!_Mail	Driving_(horse)	Google_Maps	Yahoo!
yahoo mapquest	MapQuest	Yahoo!_Maps	List_of_search_engines	Yahoo!
yahoo! mail	Yahoo!_Mail	Yahoo!
yahoo maps	Yahoo!_Maps	Yahoo!
gucci	Gucci	Gucci_Gucci	Gucci_Mane
mackenzie foy	Mackenzie_Foy
mackenzie childs	MacKenzie-Childs	Jacqueline_McKenzie	MacKenzie_Mauzy	Mackenzie_Phillips
hernando county property appraiser	Appraiser	Property_tax	Hernando_County,_Florida
spring hill rentals	The_Rentals	Spring_Hill,_Tennessee	Spring_Hill_College	Spring_Hill,_Florida
EU economic indicators	Economy_of_the_European_Union	European_Union	Economic_indicator
dehumidifier	Dehumidifier	Humidifier
whole house dehumidifier	Dehumidifier	House_(TV_series)	Whole-house_fan
google search	Google_Search	Google	Google_search
autozone.com	AutoZone_Park	AutoZone
used car parts	Used_car	Audi	Cars_(film)	List_of_auto_parts
face transplants wiki	Wiki	Transplant	Face_transplant	Face
"Connie Culp"	Connie_Culp	Culp
"Connie Culp" wikipedia	Connie_Culp	Culp	Wikipedia	Maria_Siemionow
First "Face Transplant"	World_War_I	Isabelle_Dinoire	Face_transplant
"Isabelle Dinoire"	Connie_Culp	Isabelle_Dinoire
Isabelle Dinoire	Isabelle_Dinoire	Bohdan_Pomahač
Isabelle Dino*	Isabelle_(proof_assistant)	Dino_Jelušić	Dino_(automobile)	María_Isabel
Isabelle "face transplants"	Isabelle_(proof_assistant)	Isabelle_Dinoire	Face_transplant
"Richard Norris"	Erol_Alkan	Richard_Norris_(musician)	David_Ball_(musician)	R._Norris_Williams
first "face transplant" surgery in the world	Isabelle_Dinoire	Oral_surgery	World_War_I	Earth	Organ_transplantation	Face_transplant
first "full face transplant" Oscar	World_War_I	Academy_Award	Face_transplant	OSCAR
first "full face transplant"	World_War_I	Dallas_Wiens	Face_transplant
Akira Kurosawa influence	Kurosawa	Akira_Kurosawa	Sphere_of_influence	Yojimbo_(film)
Akira Kurosawa influence india	Yojimbo_(film)	Akira_Kurosawa	India	Sphere_of_influence
"Akira Kurosawa" indian cinema	Indian_cinema	Akira_Kurosawa	Cinema_of_India
"Akira Kurosawa" chinese cinema	Cinema_of_China	Akira_Kurosawa	Ran_(film)	Criticism_of_Akira_Kurosawa
charter email	Charter_Communications	Canadian_Charter_of_Rights_and_Freedoms	Email	Charter_airline
afghanistan war	Afghanistan_War	War_in_Afghanistan_(2001–present)	War_in_Afghanistan_(2001-present)	Soviet_war_in_Afghanistan
afghanistan history	Afghanistan	History_of_Afghanistan	History
you tube video	Youtube	Viral_video	YouTube	Music_video
aol	AOL	Wikipedia:AOL
bollywood legislation growth	Legislation	Bollywood	Delegated_legislation	Economic_growth
bollywood legislation growth government	Regulation	Jacobin	Economic_growth	Government	Legislation	Bollywood
beauty queen killed	Homicide	Sleeping_Beauty	JonBenét_Ramsey	Beauty_pageant	Christopher_Wilder	I_Killed_the_Prom_Queen
medicare fraud	Medicare_fraud	Medicare_(United_States)
medicare fraud criteria	Medicare_fraud	Fraud	Medicaid	World_Heritage_Site	Medicare_(United_States)
Greenland highschool new hampshire	Greenland	Exeter_High_School_(New_Hampshire)	List_of_high_schools_in_New_Hampshire	Dover_High_School_(New_Hampshire)	Greenland,_New_Hampshire	New_Hampshire
Greenland high school	Greenland_High_School	High_School_High	Greenland	Secondary_education
taylor manor hospital	Camp_Taylor,_Louisville	James_Taylor	Manor_Hospital	Edward_Harrison_Taylor	Steven_Tyler	Sheffield_Manor
taylor manor hospital map	Taylor_series	Wayne_Manor	Function_(mathematics)	Bashford_Manor,_Louisville	Manor_Hospital
taylor manor maryland	Taylor_Momsen	Manor	Manor_Park,_London	Province_of_Maryland	Zachary_Taylor	James_Taylor
taylorhealth location	Filming_location
FISA	International_Rowing_Federation	FISA	FISA_Amendments_Act_of_2008	Foreign_Intelligence_Surveillance_Act
judges on fisa court	United_States_Foreign_Intelligence_Surveillance_Court	Judge_Judy	Foreign_Intelligence_Surveillance_Act	Judge	United_States_federal_judge
1990 FISA wiretap applications	Wiretap	FISA	NSA_warrantless_surveillance_controversy	Foreign_Intelligence_Surveillance_Act	Xfce	Telephone_tapping
judges FISA court	United_States_Foreign_Intelligence_Surveillance_Court	Judge	Foreign_Intelligence_Surveillance_Act	United_States_federal_judge
judges FISA court 2005	United_States_Foreign_Intelligence_Surveillance_Court	Judge_Judy	NSA_warrantless_surveillance_controversy	United_States_federal_judge
Jp Morgan Chase	J._P._Morgan	JPMorgan_Chase
atari	Atari,_Inc.	Atari_2600	Atari
atari arcade	List_of_Atari_arcade_games	Arcade	Atari	Atari_2600	Arcade_game
groin infections	Post-mastectomy_lymphedema	Tinea_cruris	Infection	Groin
patient.co..uk	Health	Pregabalin	Patient_UK
nhs choice	National_Health_Service	National_Health_Service_(England)	Choice
berkley insurance	Liberty_Mutual	University_of_California,_Berkeley	Insurance	W._R._Berkley
berkley insurance about us	Berkley	W._R._Berkley	Insurance	Berkeley,_California	United_States_dollar
"berkley insurance" "about us"	Insurance	Berkeley,_California	United_States_dollar
dinosaurs	Dinosaur	Dinosaurs_(TV_series)
walking with dinosaurs bbc	BBC	Walking_with_Dinosaurs_(film)	Walking_with_Dinosaurs
apple id	Apple_ID	Apple_inc
how to get a pay raise	Salary	2005_Pennsylvania_General_Assembly_pay_raise_controversy	United_States_Military_Pay	How-to
tips pay raise	Salary	2005_Pennsylvania_General_Assembly_pay_raise_controversy	Pay-per-view	Wing_tip	Efficient_energy_use
weatherstripping	Duct_tape	Weatherstripping
computer worms	Morris_worm	Computer_worm	List_of_computer_worms
malware	Malware	Linux_malware
legal system	List_of_country_legal_systems	Law	System
zhaopei	Chen_style_tai_chi_chuan	549	Princess_Xu_Zhaopei
fee of advice	Advice	Fee	Advice_(opinion)	Financial_adviser
type lawyer advice	Barrister	Financial_adviser	Lawyer	Type–token_distinction
Charles Basil	Basil_of_Caesarea	Charles_Basil_Price	Charles_I_of_Naples	Basil_Charles_Godfrey_Place
"Charles Basil"	Diana_Weston	Charles_I_of_Naples	Arthur_Richards,_1st_Baron_Milverton	Basil_Charles_Godfrey_Place	Basil_of_Caesarea	Charles_Basil_Price	Charles_Foster_(writer)
Basil family	Basil	Thai_basil	Basil_II	Family_(biology)
belbin team roles	Meredith_Belbin	Belbin_Team_Inventory	Role	The_A-Team_(film)
the great gatsby	The_Great_Gatsby	The_Great_Gatsby_(2013_film)	The_Great_Gatsby_(1974_film)
difference between mitosis and meiosis	Cadency	Mitosis	Meiosis
exam	Exam_(film)	Test_(assessment)	Exam
Black history month	Black_History_Month	Black_History_Month_(song)
bobcat tractor	Bobcat_Company	Tractor
bobcat tractor attachment	Bobcat_Company	Virus	Tractor
amazon	Amazons	Amazon	Amazon.com
state of decay	State_of_Decay	State_of_Decay_(video_game)
hunting	Fox_hunting	Hunting
hunting arizona	Tucson,_Arizona	Arizona	Hunting
Sunspots Wikipedia	Wikipedia	Sunspot	Sunspot_(comics)
Sunspots Environmental effects	Environmental_impact_assessment	Natural_environment	List_of_environmental_issues	Sunspot	Solar_variation
Sunspot life cycle	Biological_life_cycle	Solar_cycle	Sunspot	Software_release_life_cycle	Man-in-the-browser
Are sunspots local burnouts	Sunspot_cycle	Keloid	Burnout_(vehicle)	Sun	Sunspot	Local_area_network
How do sunspots effect us	Sunspots_(economics)	How_Do	Solar_variation	United_States	Sunspot	Doctor_of_Osteopathic_Medicine
hayden panettiere	Panettiere	Hayden_Panettiere
lindsay lohan cancels	Speak_(Lindsay_Lohan_album)	Lindsay_Lohan	Cancels
carol burnett	The_Carol_Burnett_Show	Carol_Burnett
yahoo! dating	Online_dating_service	Dating	Yahoo!_Answers	Yahoo!
yahoo! deals	Yahoo!
death	Recent_Deaths	Death	Death_Note
death of a salesman	Death_of_a_Salesman_(1966_BBC_drama)	Death_of_a_Salesman_(1985_film)	Death_of_a_Salesman	Death_of_a_Salesman_(1951_film)
death penalty for penn state	Death_penalty_(NCAA)	Pennsylvania_State_University	Death_penalty	Penn_State_child_sex_abuse_scandal
death of rizal	Crucifixion_of_Jesus	Josephine_Bracken	José_Rizal	Rizal_Nurdin
death of robin	Tim_Drake	Robin_Williams	Batman:_A_Death_in_the_Family	Death_(DC_Comics)	List_of_drug-related_deaths	Robin_Hood's_Death
google	Google_Earth	Google
yahoo! games	Yahoo!_Games	Yahoo!
mi	Mil_Mi-8	Mile	Mil_Mi-24
yahoo! mail	Yahoo!_Mail	Yahoo!
miss universe	Miss_Universe_2010	Miss_Universe
mister rogers	Fred_Rogers	Mister_Rogers'_Neighborhood
mistral	Gabriela_Mistral	Mistral_(wind)
mistress fortune	Mistress_Fortune	Mistresses_(UK_TV_series)	Mistress_of_the_Robes	Fortune_FitzRoy,_Duchess_of_Grafton
mystery shopper	Mystery_Date_(game)	Mystery_shopping
russian submarine Kursk sinks	Russian_submarine_Kursk_(K-141)	Russian_submarine_K-141_Kursk	Sink	Russian_submarine_Kursk_explosion
russian submarine Kursk fleet	Royal_Navy	Russian_submarine_K-141_Kursk	Kursk_submarine_disaster	Russian_submarine_Kursk_explosion
russian submarine Kursk on-board commander	Russian_submarine_Kursk_(K-141)	Russian_submarine_K-141_Kursk	Kursk_submarine_disaster	Russian_submarine_Kursk_explosion	Commander
kursk commander	Battle_of_Kursk	Kursk	Kursk_submarine_disaster	The_Battle_Of_Kursk	Commander
kursk submarine commander	Russian_submarine_Kursk_(K-141)	Submarine	Russian_submarine_K-141_Kursk	Kursk_submarine_disaster	Russian_submarine_Kursk_explosion	Commander
kursk sink express regret	Acceptance	Regret_(horse)	Kursk	Automobile	Glossary_of_graph_theory	Daily_Express
kursk countries express regret	Europe	Sovereign_state	EXPRESS_(data_modeling_language)	Regret_(horse)	Malaysia	Kursk_Oblast	Battle_of_Kursk
kursk 2000 countries express regret	Sovereign_state	2000	EXPRESS_(data_modeling_language)	Regret_(horse)	Malaysia	Kursk_Oblast	Battle_of_Kursk
kursk UK subs in area	U.K._Subs	Submarine	Battle_of_Kursk	Kursk	Russian_submarine_Kursk_explosion	Area	Sub-Saharan_Africa
yahoo	Yahoo!
roku purple screen	Purple	Roku	Computer_monitor	Purple_prose
angel porrino	Angel_Porrino	Holly's_World
best flea bomb	Flea	The_Best_(song)	Fogger	Flea_bomb
peanut butter cookies without brown sugar	Brown_sugar	Peanut	Peanut_butter	Peanut_butter_cookie
how many teaspoons in 1 4 cup	Cup_(unit)
the glades season 3	List_of_The_Glades_episodes	WWE_NXT	Burn_Notice_(season_3)	The_Glades_(TV_series)	Wizards_of_Waverly_Place_(season_3)
kristen renton	Sean_Kinney	Kristen_Renton
gangnam style christmas lights	Christmas_lights	Gangnam-gu	Music_genre	Oxford_Street
map	Map	Mind_map
office depot	Office_Depot	Office
aqueduct race track	Aqueduct	Aqueduct_Race_Track	Aqueduct_Racetrack
pakistan news	Pakistan	History_of_Pakistan	The_News_International
gmail	Gmail/History	Gmail
cal racing	Horse_racing	Auto_racing	Cal_Wells_(Motor_racing_businessman)	California_Golden_Bears_football
guide dulles airport	Dulles_Airport	Girl_Guides	Washington_Dulles_International_Airport	Dulles
Depression Definition	Depression_(mood)	Depression	Infertility
Depression Definition Merck Manual	Merck_&_Co	Merck_Manual_of_Diagnosis_and_Therapy	Major_depressive_disorder	Fugue_state	Infertility
myyahoo mail	My_Yahoo!	Yahoo!_Mail	Mail_(application)	Yahoo!
ford fiesta 2002	Ford_Fiesta_S2000	Ford_Fiesta
mediacom cable	Mediacom	Cable_Television	Cable_television
first source bank	First_Source_Bank	Bank	1st_Source
lakeshore ford	Edsel_Ford	Lakeshore,_Ontario	Ford_Motor_Company	Fort_Ticonderoga
espn	ESPN+	ESPN
fantasy football leagues	Fantasy_sport	Fantasy_football_(American)	La_Liga	Fantasy_Football_League
southeast sun	Sun_Bear	Southeast_Sun_Online_Edition	The_Southeast_Sun	Sun_Yat-sen
connecticut fire academy training	Connecticut	National_Fire_Academy	Arkansas_Fire_Academy	Fire	Academy	Training
connecticut fire academy	Wildfire	Connecticut	National_Fire_Academy	Arkansas_Fire_Academy	Academy	Manchester,_Connecticut
scooter comparison	Scooter_(band)	Comparison_(grammar)	Kick_scooter
dooney bourke look alike purses	Handbag	Look-alike	Dooney_&_Bourke	Dooney_&_Bourke
pictures of dooney bourke look alike purses	Dooney_&_Bourke	List_of_proverbial_phrases	Handbag	Mary-Kate_and_Ashley_Olsen	Look-alike	Film
dooney bourke purses	Handbag	Talk:Dooney_&_Bourke	Dooney_&_Bourke	Dooney_&_Bourke
ps 2 games	Video_game	Adobe_Photoshop	PlayStation_2
new ps 2 games	Video_game	Adobe_Photoshop	PlayStation_2
lark voorhies	Lark_Voorhies	How_High
presidential polls	Election	Nationwide_opinion_polling_for_the_United_States_presidential_election,_2012	Iranian_presidential_election,_2009	Statewide_opinion_polling_for_the_United_States_presidential_election,_2012	United_States_presidential_election,_2008
yahoo! dating	Online_dating_service	Dating	Yahoo!_Answers	Yahoo!
yahoo! profile	User_profile	Yahoo!
presidents	List_of_Presidents_of_the_United_States	President	President_of_the_United_States
presidents day 2012	United_States_presidential_election,_2012	Washington's_Birthday	President's_Day	2012
presidents email	Yahoo!_Mail	President_of_the_United_States	Email
presidents elected	President	List_of_United_States_Presidents_by_age	Election	President_of_the_United_States
presidents elected without popular vote	List_of_United_States_presidential_elections_by_popular_vote_margin	Election	Presidents	President	President_of_the_United_States
facebook log	File:Facebook.svg	Login	Facebook
nesquik recall	Product_recall	Nesquik	Recall_election	Nesquik_(mix)
yahoo! mail	Yahoo!_Mail	Yahoo!
yahoo	Yahoo!
yahoo mail	Yahoo!_Mail	Yahoo!
yahoo mail india	Yahoo!_Mail	India	Yahoo!
yahoo mail plus	Yahoo_mail	Yahoo!_Mail	E-mail_address	Plus_(interbank_network)
facebook log in	Login	Facebook_Home	Facebook
les miserables	Les_Misérables_(musical)	Les_Misérables
lamborghini reventon	Lamborghini	Lamborghini_Reventón
the secret garden	Secret_Garden_(TV_series)	The_Secret_Garden	The_Secret_Life_of_the_American_Teenager	Garden
the secret garden adaptations	Return_to_the_Secret_Garden	The_Secret_Garden	The_Giver	The_Secret_Garden_(1949_film)	Secret_garden
aol mail login	AOL_Mail	Login
online console games inuyasha series	InuYasha	List_of_video_game_franchises	Online_and_offline	Video_game_console	History_of_video_game_consoles_(seventh_generation)
inuyasha games	The_Legend_of_Zelda	InuYasha:_Feudal_Combat	InuYasha
dog heat	Canine_reproduction	Estrous_cycle	Dog
dog heat breeding	Canine_reproduction	Estrous_cycle	Dog	Reproduction	Dog_breeding
test tube sealing services	Neural_tube_defect	Grand_Falls-Windsor	Seal_(emblem)	Cathode_ray_tube	In_vitro_fertilisation
hermetic sealing services	Heat_sealer	Jewish_prayer	Hermetic_seal	Seal_(emblem)	Hermit
swahili traditional food recipes	Swahili_language	Food	Recipe	Tradition	Chinese_food_therapy
kenya swahili traditional food recipes	Swahili_language	Food	Kenya	Recipe	Tradition
bart schedules and fares	Taxicab	Dumbarton_Express	Bay_Area_Rapid_Transit	Job_scheduler
bart map	Bart_Simpson	File:BARTMapDay.svg	Bay_Area_Rapid_Transit	Map
arsenal	Arsenal_F.C.	Arsenal_F.C	Arsenal
powerball	Powerball	Powerball_(Australia)
english premier league	English_Premier_League	Premier_League	2013–14_Premier_League
legalzoom	Legal_malpractice	LegalZoom
michworks	
michigan unemployed	Michigan	Unemployment_benefits	Unemployment
dora games	Video_game	Japanese_Mahjong	Dora_the_Explorer	Dora_the_Explorer_video_games
free dora games	Video_game	Japanese_Mahjong	Free_software	Dora_the_Explorer_video_games	Dora_the_Explorer
free dora games online	Croatia_in_the_Eurovision_Song_Contest	Freeware	Dora_the_Explorer_video_games	Dora_the_Explorer	Online_game
road trip FAQ	College_Road_Trip	FAQ	Road_trip	Road_Trip
planning a road trip	Planning	On_the_road	Road_trip	Road_Trip
jeopardy (game show)	Jeopardy!	Game_show
jeopardy (game show) wikipedia	Jeopardy!_(UK_game_show)	Jeopardy!_(Quebec_game_show)	Game_show	Wikipedia	Jeopardy!
wikipedia jeopardy	Jeopardy_(album)	Wikipedia	Jeopardy!	Double_jeopardy
casa de campo	Casa_de_Campo	Casa_de_Campo,_Dominican_Republic
define slimy	Slimy	Ponyfish
best buy	Best_Buy_Theater	Best_Buy
f5 tornadoes	Tornado	May_1968_tornado_outbreak	List_of_F5_and_EF5_tornadoes	Fujita_scale	F5_tornado
deadliest tornadoes	Tornado	Template:10_deadliest_Canadian_tornadoes	Tornado_records	Template:10_deadliest_US_tornadoes	List_of_tornadoes_causing_100_or_more_deaths
www.capitalonebank.com	Component_Object_Model	NYCB_Theatre_at_Westbury	Capital_One
dolly parton shoots down nickname	Dolly_Parton	Nickname	Transair_Georgia_airliner_shootdowns
Dolly Parton shoots down nickname	Dolly_Parton	Nickname	Transair_Georgia_airliner_shootdowns
capital one	Capital_(economics)	Capital_One
zoomcare portland	Portland,_Oregon
imdb nashville	Nashville,_Arkansas	Main_Page	Internet_Movie_Database	Nashville_(film)
connie britton	Connie_Britton	Britton
abc.com	American_Broadcasting_Company	ABC
celebrity hairstyles	Hairstyles	Celebrity	Hairstyles_in_the_1950s	Hairstyle
amanda bynes	Amanda_Bynes	The_Amanda_Show
portland crime map	Crime_mapping	Portland,_Maine	Portland,_Oregon
address numerology	Numerology	Category:Numerology	Address_(geography)
atrophy	Atrophy	Muscle_atrophy
crate and barrel	Barrel	Crate_&_Barrel	Crate_&_Barrel
furniture	Furniture_(band)	Furniture
springfield mo movie theaters	Springfield,_Missouri	List_of_movie_theaters_and_cinema_chains	Springfield_(The_Simpsons)	Movie_theater
old us coins	Nickel_(United_States_coin)	Old_Testament	No_Country_for_Old_Men_(film)	Coins_of_the_United_States_dollar
collecting old us coins	Collecting	Old_Testament	Coin	Coin_collecting	Coins_of_the_United_States_dollar
selling old us coins	Old_Testament	List_of_best-selling_video_games	No_Country_for_Old_Men_(film)	Coins_of_the_United_States_dollar
selling old "usa coins"	Coin	List_of_best-selling_albums_worldwide	United_States	Old_age	Old_Boy_(manga)
aol.com	AOL	Wikipedia:AOL
aol.com mail	AOL_Mail	AOL	Mail_(application)	File:AOL_Mail_Screenshot.png
hybrid vehicle sales usa	Hybrid_vehicle	Solar_power_in_the_United_States	Sales_tax	Hybrid_electric_vehicle	Hybrid_electric_vehicles_in_the_United_States	Plug-in_electric_vehicles_in_the_United_States
first ever hybrid car	FirstGroup	Hybrid_electric_vehicle	Hybrid_car	Hybrid_vehicle
percentage sales of hybrid vehicles in 2004 usa	2004_in_the_United_States	Hybrid_vehicle	Sales_tax	Percentage	Hybrid_electric_vehicles_in_the_United_States	Hybrid_electric_vehicle
hybrid vehicle sales as percentage in 2004 usa	2004_in_the_United_States	Hybrid_vehicle	Sales_tax	Percentage	Hybrid_electric_vehicles_in_the_United_States	Hybrid_electric_vehicle
cartoon	Animated_cartoon	Cartoon
deals and steals	List_of_National_Basketball_Association_season_steals_leaders	Steal_(basketball)	Steals_and_Deals
tim tebow rb	Kordell_Stewart	Tim_Tebow	Running_back
yahoo! travel	Yahoo_(Gulliver's_Travels)	Yahoo!_Travel	Yahoo!
tim burton	Richard_Burton	Tim_Burton
tim burton characters	Spyro_(series)	Richard_Burton	Tim_Burton
tim burton corpse bride	Tim_Burton	Corpse_Bride
tim burton movies	Feature_film	Richard_Burton	Tim_Burton
valerie eliot dies	T._S._Eliot	Valerie_Eliot	Die_(manufacturing)
renal cancer treatment   experiments	Experimental_cancer_treatment	Cancer	Kidney_cancer	Renal_cell_carcinoma	Animal_testing
renal cancer treatment	Kidney_cancer	Renal_cell_carcinoma	Cancer
cell phones	Mobile_phone	History_of_mobile_phones
sprint	Sprint_Nextel	Sprint_(running)	Sprint
black dog machine magazines	Black_Dog_(song)	Treasure_Island	Science_fiction_magazine	Unbreakable_Machine-Doll	Machine_gun
sig 522 magazine	Magazine_(firearms)	SIG_Sauer	SIG_522LR	Penthouse_(magazine)
sig 522 magazine loader	Schweizerische_Industrie_Gesellschaft	Speedloader	Semi-automatic_firearm	Eritrea
sunspots climate changes	Climate	I_Ching	Sunspot	Climate_change
sunspots affect climate changes	Climate	I_Ching	Climate_change	Affect_(psychology)	Sunspot
kardashian holiday card	Holiday	Kim_Kardashian	Christmas_card
Houston community college about	Houston_Community_College_System	List_of_colleges_and_universities_in_Houston
Houston community college location	Filming_location	Houston	Houston_Community_College_System
Kursk russia today	Russian_submarine_K-141_Kursk	Battle_of_Kursk	Kursk	RT_(TV_network)	Russia
russiatoday.ru	Tupolev_Tu-160	Milan_Jelić	RT_(TV_network)
euclid trucks	Talk:Euclid_Trucks	Euclid_Trucks
euclid trucks parts	Euclid_Trucks	Euclid
carol burnett sued	Carol_Burnett_v._National_Enquirer,_Inc.	Lawsuit	Carol_Burnett
sam elliot	Sam_Elliott
eurozone crisis	Eurozone_crisis	Eurozone	Causes_of_the_Eurozone_crisis	European_sovereign-debt_crisis
jenner divorce rumors	Divorce	Bruce_Jenner	Brody_Jenner	Rumors	Kylie_Jenner
bollywood	Bollywood	List_of_Bollywood_films
bollywood stars	Bollywood	Movie_star	List_of_Bollywood_actresses
bollywood beverly hills	Beverly_Hills,_California	Beverly_Hills	Bollywood	Beverly_Hills,_90210
bollywood oscars	Academy_Award	List_of_Indian_submissions_for_the_Academy_Award_for_Best_Foreign_Language_Film	Bollywood	Academy_award
world film industries	Pornographic_film	Film_industry	World	Cinema_of_India	Film
face transplants	Organ_transplant	Face_transplant
powerball pa lottery	Lottery_jackpot_records	Powerball	Pennsylvania_Lottery
"glenohumeral sublaxation"	Glenohumeral_joint	Dislocated_shoulder
glenohumeral sublaxation	Glenohumeral_joint	Glenohumeral	Luxation	Dislocated_shoulder	Subluxation
glenohumeral	Glenohumeral_joint	Glenoid_cavity	Glenohumeral_ligaments
gangnam style christmas lights	Christmas_lights	Gangnam-gu	Music_genre	Oxford_Street
$300k in gold dust found	Gold
emily squires dies	Dorothy_Squires	Emily_Squires	Die_(manufacturing)
silicone roof coating	Silicone	Roof_coating
silicone roof coating uk	Silicone	United_Kingdom	Metal_roof	Roof_coating	Roof
silicone roof coating uk alternatives	Roof_coating	Silicone	United_Kingdom	Poached_egg	Metal_roof	Roof
roof coating house temperature down uk	Down_quark	UK_Singles_Chart	Roof_coating	Green_roof	House_music	Roof	Temperature_(song)
facial flushing and high blood pressure	Flushing_(physiology)	Hypertension	High_blood_pressure	Facial_(sex_act)
facial flushing	Flushing_(physiology)	Facial_blushing	Facial_(sex_act)
tax junk food benefits	Fat_tax	Junk_food	Tax	Welfare
tax junk food benefits un	Fat_tax	Junk_food	Tax	Welfare
tax junk food benefits UN evidence	Fat_tax	Evidence_(law)	Welfare	Food	Tax	Junk_food
high calorie food tax evidence based	Fat_tax	Hypertension	Calorie	Evidence-based_medicine	High-protein_diet
high calorie snack tax evidence based	Fat_tax	Calorie_restriction	Hypertension	Snack_tax	Calorie	Evidence-based_medicine
government intervention tax "junk food"	Fat_tax	Public_sector	Junk_food	Government_intervention	Tax
dollar euro exchange rate	Exchange_rate	Dollar	Euro
irvine california	University_of_California,_Irvine	Irvine,_California
pandora	Pandora_Hearts	Pandora
currency converter	Exchange_rate	Currency_converter
$425 million jackpot	Lottery_jackpot_records	Million	Prize	Mega_Millions
bangladesh	History_of_Bangladesh	Bangladesh
yahoo! calendar	Yahoo!_Calendar	Yahoo!
circuit city	Talk:Circuit_City_Stores	Circuit_City_Stores	Circuit_City
citibank	Citibank_Singapore	Citigroup	Citibank
citi	City	Citigroup	Citi_Field
citicards	Citigroup	Citibank
citizens bank	Citizens_Bank	Citizens_Financial_Group	Citizens_Bank_Park
citicards sign on	Sign-on	Citigroup	Authorization_hold
citicards sign on page	Sign-on	Wikipedia:Sign_your_posts_on_talk_pages	Citigroup	Larry_Page	Signs
citicards credit cards	Credit_cards	Citigroup	Citibank	Credit_card
citicards click to pay	Paid_To_Click	Citigroup	Click.to	Pay_per_click
citicards online bill pay	Citigroup	Investing_online	Bill_Clinton
citicards online login	Login	Citigroup	Online_banking
citicards thank you points	Point_(basketball)	Thank_You_(Falettinme_Be_Mice_Elf_Agin)	Citigroup	Thank_You_for_Being_a_Friend	Thank_You
citicards thank you rewards	AirTran_Airways	Thank_You_(Falettinme_Be_Mice_Elf_Agin)	Citigroup
ap poll top 25	AP_Top_25	Associated_Press	Southern_Mississippi_to_the_Top	AP_Poll
china aircraft carrier	Chinese_aircraft_carrier_Liaoning	Aircraft_carrier	China	Chinese_aircraft_carrier_programme
yahoo! mail	Yahoo!_Mail	Yahoo!
youtube	Youtube	YouTube	List_of_YouTube_personalities
youtube broadcast yourself	Youtube	YouTube_-_Broadcast_Yourself	YouTube
youtube downloader	History_of_YouTube	Youtube	YouTube
youtube video	Youtube	Viral_video	YouTube	Music_video
yahoo mail	Yahoo!_Mail	Yahoo!
jamie grace	Ready_to_Fly_(Jamie_Grace_album)	Jamie_Grace
is tithing required	Tithing_settlement	Tithe
clayton state university	Talk:Clayton_State_University	Clayton_State_University
guy fieri responds	Respond	Fieri	Guy_Fieri
marilyn and sarah	Marilyn_(hill)	List_of_Twin_Peaks_characters	Marilyn_Manson	Marilyn_Monroe
financial modeling	Financial_risk_modeling	Financial_modeling
obama family tree	Michelle_Obama	Family_tree	Family_of_Barack_Obama
obama's mother	Mother_(1996_film)	Family_of_Barack_Obama	Barack_Obama	Ann_Dunham
stuhrling watches	Stührling	Watch	Skeleton_watch
ebooks	Wikipedia:Books	E-book
inside out movie	Inside_Out_(2011_film)	In-N-Out_Burger	Inside_Out_(2015_film)	Coming_out	Film
teacher evaluation peer versus students	Peer_review	Versace	Self-_and_Peer-Assessment	Peer_group	Student	Evaluation	Teacher
price is right model	Model_(person)	The_Price_is_Right_models	Price	Prince_(musician)	The_Price_Is_Right
jay cutler injury	Jay_Cutler_(bodybuilder)	Injury	Jay_Cutler_(American_football)
led zeppelin	Led_Zeppelin	Led_Zeppelin_(album)
australia wine export data	Australia	Export	Australian_wine	Data
australia wine export to United States	Australia	Export	Economy_of_Australia	Australia_–_United_States_Free_Trade_Agreement	Australian_wine	United_States
australia female winemaker	Winemaker	Woman	Australia	Australian_wine
kgrs	WMT_(AM)	WHO_(AM)	KGRS
scciowa	
IMG	IMG_(company)	IMG_Models	IMG_(business)
international management group	IMG_(company)	International_Management_Group	American_International_Group	Project_management
vijay singh img	Vijay_Singh	IMG_(company)	Vijay_Kumar_Singh
amlodipine besylate	Amlodipine	Olmesartan/amlodipine	Atorvastatin/amlodipine	Besylate
amlodipine besylate 5mg	Amlodipine	Amlodipine/valsartan	ABC_South_East_SA
icbc knowledge test online	Test_(assessment)	Drug_test	Knowledge	Internet	Science	Industrial_and_Commercial_Bank_of_China
penticton bc	Penticton_Regional_Airport	Penticton
penticton bc canada	Penticton_Regional_Airport	Penticton	Canada_men's_national_soccer_team
penticton bc hotels	Hotel	Walt_Disney_World_Resort	Penticton
penticton bc real estate	Real_estate	Extraterrestrial_real_estate	Penticton
penticton bc weather	Penticton_Regional_Airport	Penticton	Weather
penticton	Penticton_Regional_Airport	Penticton
penticton herald	Penticton_Regional_Airport	Penticton	Penticton_Herald
pentagon	Pentagon	The_Pentagon
penelope cruz	Penelope_Cruz	Penélope_Cruz	Taio_Cruz
yahoo! dating	Online_dating_service	Dating	Yahoo!_Answers	Yahoo!
iran fired on drone	Military_of_Iran	Unmanned_aerial_vehicle	Iran	Kiln
xbox 360	Xbox_360_technical_problems	Xbox_360
xm radio	List_of_XM_Satellite_Radio_channels	XM_Satellite_Radio	XM_satellite_radio
xmas	Xmas	Happy_Xmas_(War_Is_Over)
xmas cards	Xmas	Christmas	Happy_Xmas_(War_Is_Over)	Greeting_card
xmas pictures	Happy_Xmas_(War_Is_Over)	Main_Page	Christmas	Film
xmas presents	Xmas_Story	Xmas	Happy_Xmas_(War_Is_Over)
Xmas presents	Xmas_Story	Xmas	Happy_Xmas_(War_Is_Over)
scythe	Scythe	War_scythe
scythe mythology	Scythe	Echidna_(mythology)	Death_(personification)	Greek_mythology	Saturn_(mythology)
amc breaking bad	Breaking_Bad_(season_5)	Breaking_Bad	AMC_(TV_channel)
north korean assassination weapons	North_Korea	Nuclear_weapon	Assassination	North_Korea_and_weapons_of_mass_destruction
oprah scare	The_Oprah_Winfrey_Show	The_Scare	Scary_Movie_4
jaco costa rica	Jacó,_Costa_Rica	Costa_Rica
map of costa rica	Costa_Rica	Stone_spheres_of_Costa_Rica	Level_(video_gaming)
four seasons costa rica	Costa_Rica	Four_Seasons_Hotels_and_Resorts	Four_Seasons_Resort_Costa_Rica
papagayo costa rica map	Papagayo_wind	Costa_Rica	Stone_spheres_of_Costa_Rica	Level_(video_gaming)
lancaster movie showtimes	Showtime	Feature_film	Alan_Lancaster	Showtime_(film)
homes for sale lancaster ca	Real_estate	Lancaster,_California
6am band	AM	Musical_ensemble	U_(TV_channel)	Sixx_am	All_or_Nothing_(band)
gucci	Gucci	Gucci_Gucci	Gucci_Mane
diabetes education posters	Billboard	Education	Diabetes_mellitus	American_Diabetes_Association
nih diabetes	National_Institutes_of_Health	Diabetes_management	Diabetes_mellitus	Diabetes_mellitus_type_2
craigslist n ms	Craigslist	List_of_PlayStation_games	List_of_colleges_and_universities_in_Mississippi	Microsoft
march madness	NCAA_March_Madness_(CBS/Turner)	March_Madness	NCAA_Men's_Division_I_Basketball_Championship
march madness 2012 winning tean	The_Winning_Team	UEFA_Euro_2012	2012_NCAA_Men's_Division_I_Basketball_Tournament	NCAA_Men's_Division_I_Basketball_Championship	The_A-Team	2012_March_Madness
march madness 2012 winning team	The_Winning_Team	UEFA_Euro_2012	2012_NCAA_Men's_Division_I_Basketball_Tournament	NCAA_Men's_Division_I_Basketball_Championship	The_A-Team	2012_March_Madness
march madness 2012 runner up	2012_NCAA_Men's_Division_I_Basketball_Tournament	NCAA_Men's_Division_I_Basketball_Championship	2013_March_Madness	March_Madness_2012	Runner-up	UEFA_Euro_2012	Baserunning
march madness 2012 host city	Presenter	2012_NCAA_Men's_Division_I_Basketball_Tournament	NCAA_Men's_Division_I_Basketball_Championship	NCAA_March_Madness_(CBS/Turner)	2012_March_Madness	The_City_(MTV_series)
march madness 2012 host stadium	Master_of_Ceremonies	UEFA_Euro_2012	2012_NCAA_Men's_Division_I_Basketball_Tournament	NCAA_Men's_Division_I_Basketball_Championship	Stadium
march madness 2012 final four	NCAA_March_Madness_(CBS/Turner)	2012_NCAA_Men's_Division_I_Basketball_Tournament	NCAA_Men's_Division_I_Basketball_Championship
march madness 2012 number teams	2012_NCAA_Men's_Division_I_Basketball_Tournament	NCAA_Men's_Division_I_Basketball_Championship	Number_(sports)	NCAA_March_Madness_(CBS/Turner)	Varsity_team	2012_March_Madness
march madness slang	NCAA_March_Madness_(CBS/Turner)	March_Madness	NCAA_Men's_Division_I_Basketball_Championship	Slang
march madness slang expression	Internet_slang	Utterance	NCAA_Men's_Division_I_Basketball_Championship	Slang
march madness semi finals	March_Madness	Single-elimination_tournament	NCAA_Men's_Division_I_Basketball_Championship
heart attack causes	Myocardial_infarction	Kawasaki_disease	Heart_failure	Heart_attack
heart attack causes nhs	Etiology	National_Health_Service	Myocardial_infarction	Myocarditis	Heart_attack
heart attack causes site:nhs.uk	Myocardial_infarction	Kawasaki_disease	.uk
buy dehumidifier, reviews	Film_criticism	Dehumidifier	Buy,_Kostroma_Oblast	Desiccant
buy dehumidifier, reviews, uk	Dehumidifier	Review	United_Kingdom	Trade
diet	Dieting	Diet_of_Japan	Diet_(nutrition)	Diet
low carb diet	Atkins_diet	Low-carbohydrate_diet
heidi klum	Klum	Heidi_Klum
facebook sign up	History_of_Facebook	Facebook.com	Facebook	Up_(2009_film)	Sign
theresa faiss dies	Lena_Horne	Death	Mother_Teresa	Teresa_of_Ávila
holly petraeus	Holly_Petraeus	Holly	David_Petraeus	Petraeus
denise richards	Denise_Richards	Denise_richards	Denise_Richards:_It's_Complicated
texas secession	Texas_secession_movements	Secession	Secession_in_the_United_States	Texas_Secession_Movement	Texas
wells fargo sign on	Sign-on	Fargo_(film)	Wells_Fargo
longs hawaii kai	Longs,_South_Carolina	Kekaha_Kai_State_Park	Hawaii_Kai,_Hawaii
waimanalo feed supply	100_Feet	Waimānalo,_Hawaii	Fodder	Supply_and_demand	Power_supply
dinar trade	Dinar	International_trade	Iraqi_dinar
keolu theaters	Theatre
fandango movies times	Fandango_(ticket_service)	The_Times	Fandango_(1985_film)	Grim_Fandango	Film
kahala theaters	Jack_Lord	Hawaii	Honolulu	Movie_theater
fandango.com	Fandango_(ticket_service)	Fandango	Fandango.com	Fandango!
kaneohe theaters	Kaneohe,_Hawaii	Marine_Corps_Air_Station_Kaneohe_Bay	David_Akui	Theatre
water gardens cinema 6	Water_Lilies	Garden	Film	Water_garden
gi joe retaliation	G.I._Joe:_Retaliation	G.I._Joe
pb teen pottery barn	Pb	Paperback	Pottery_Barn	Adolescence
gymboree play and music	Gymboree	Play_(theatre)	Music
gymboree baby clothes	Gymboree	Baby_Clothes
boh.com	BOH_Plantations	Component_Object_Model	Boh	BOH_(drug)
wells fargo	History_of_Wells_Fargo	Wells_Fargo
walmart.com	Walmart	Criticism_of_Wal-Mart
facebook	History_of_Facebook	Facebook
hawaiian electric	Electricity	Hawaiian_language	Hawaiian_Electric_Industries	Music_of_Hawaii
exxon gas station	Exxon	Filling_station	Esso
google	Google_Earth	Google
gmail sign in account	Google_Account	User_(computing)	At_sign	Gmail
amazon	Amazons	Amazon	Amazon.com
hgea union	Union_(American_Civil_War)	David_de_Gea	Union_representative
flame designs	Fire	Flamme	Design	FLAME
flame designs car motorcycle	Motorcycle	Industrial_design	Fire	Automobile	Blue_Flame_(car)	Motorcycle_design
designer dogs moral	Designer_dog	Moral	Dog_hybrid	Dog
"designer" dogs	Designer_dog	Dog_hybrid	Dog
is lean cuisine healthy	Health	Lean_manufacturing	Lean_Cuisine
tilapia recipes	Aquaculture_of_tilapia	Recipe	Tilapia
flat iron steak recipes	Flat_iron_steak	Recipe	Talk:Flat_iron_steak
hornet	McDonnell_Douglas_F/A-18_Hornet	Hornet	USS_Hornet_(CV-12)
stafflinq login	Login
paula deen	Paula_Abdul	Paula_Deen	Paula_Broadwell
actress in girl with the dragon tattoo	Rooney_Mara	Noomi_Rapace	The_Girl_with_the_Dragon_Tattoo_(2009_film)	Actor
rooney mara images	Rooney_Mara	Kate_Mara	Images_(film)
winner of the voice 2013	Winner_(Jamie_Foxx_song)	The_Voice_(U.S._season_4)	Voice_acting	Hugh_Laurie	List_of_vegans
danielle bradberry bio	Ray_Bradbury	Danielle_Manning	Danielle_Bradbery	Biography
the bling ring	Bling_Ring	The_Bling_Ring
white bean chicken chili	Phaseolus_vulgaris	Chili_con_carne	Chicken	Chili_pepper	Common_bean
met rx protein plus	Protein	Plus_(interbank_network)	Met-Rx
gnc health store	GNC_(store)	GNC	Health_food_store
netflix	Netflix
movie phone	Phone_(film)	Extreme_Movie	Moviephone	Date_Movie	Telephone	Film
port arthur martin bryant	Port_Arthur,_Tasmania	Martin_Bryant	Port_Arthur_massacre_(Australia)	Arthur_Martin_(cricketer)
port arthur martin bryant gun crime	Port_Arthur,_Tasmania	Martin_Bryant	Port_Arthur_massacre_(Australia)	Arthur_Martin_(cricketer)	Crime
lexington county sc	Lexington_County,_South_Carolina	Lexington,_South_Carolina
AMT tax IRS	Alternative_minimum_tax	IRS	Amt_(country_subdivision)	Tax	Internal_Revenue_Service
netflix login	Google	Enterbrain	Apple_tv	Netflix
comcast xfinity	Comcast	Xfinity	Comcast_Spotlight
introduction trust fund	Social_Security_Trust_Fund	Introduction_(music)	Trust_law
wiki trust fund	Wiki	Trust_fund_tax	Child_Trust_Fund	Trust_law
trust fund	Trust_fund	Social_Security_Trust_Fund	Trust_law
"designer dogs"	Goldendoodle	Designer_dog	Dog_hybrid	Designer_dogs
"designer dogs" crossbreeds	Crossbred_dog	List_of_crossbred_dogs	List_of_dog_crossbreeds	Dog_hybrid	Designer_dogs
brian stann	UFC_on_Fuel_TV:_Silva_vs._Stann	Brian_Stann
paralegal career	Career	Paralegal	Blackstone_Career_Institute
$23 million lottery winner forgot	Michael_Carroll_(lottery_winner)	Million_Lottery	Kentucky_Lottery	The_Winner_(TV_series)
music man performances	The_Music_Man	The_Music_Man_(1962_film)	Concert	Electronic_music
music man script	Method_Man	Play_(theatre)	The_Music_Man_(1962_film)	The_Script
Kurosawa	Kiyoshi_Kurosawa	Kurosawa	Akira_Kurosawa	List_of_creative_works_by_Akira_Kurosawa
Kurosawa's wife	Akira_Kurosawa	Rashomon_(film)	Wife
how accurate are home pregnancy tests	Home_insurance	Talk:Pregnancy_test	Pregnancy	Accuracy_and_precision	Pregnancy_test
which home pregnancy tests are most accurate	Home_insurance	Pregnancy	Accuracy_and_precision	Ectopic_pregnancy	Pregnancy_test
install roof insulation	Thermal_insulation	Building_insulation	Roof
how roof installation prevent heat	Domestic_roof_construction	Heat	Military_base	Roof
SUNY colleges	State_University_of_New_York	College	SUNY	Community_college	SUNY_Broome_Community_College
SUNY albany hospital location	Albany,_New_York	SUNY_Downstate_Medical_Center	University_at_Albany,_SUNY	Hospital	Acholi_people
"SUNY albany hospital" location	Hospital	Acholi_people	University_at_Albany,_SUNY
albany university hospital location	Albany_Hospital	University_of_Michigan_Health_System	University_at_Albany,_SUNY	Springfield_(The_Simpsons)
SUNY plattsburgh athletics	Sunny_Leone	SUNY_Plattsburgh	Track_and_field	State_University_of_New_York_at_Plattsburgh
spain weather system	Economy_of_Spain	Weather	Spain
spain weather system annual	Economy_of_Spain	Annual_plant	Spain	Weather
spain annual rainfall temperature	Climate	Temperature	Year	Spain	Rain
travel spots room prices	Dormitory	Tesla_Roadster	Price	Tourism
travel spots room prices hawaii	Dormitory	One_Life_to_Live_minor_families	Tourism	Hawaii	Miss_Hawaii_USA
comparison hotels new york city	New_York_City_Hotels	PlayStation	Walt_Disney_World_Resort	New_York_City	Grand_Hotel_(New_York_City)